date,object_id,cod_istatn,nome_com,nome_pro,positivi,deceduti,totale
2020-04-09,29,03013030,BRIENNO,COMO,1,0,1
2020-04-09,30,03018144,SANT`ANGELO LOMELLINA,PAVIA,0,1,1
2020-04-09,31,03015155,NOSATE,MILANO,3,0,3
2020-04-09,32,03108028,LISSONE,MONZA E DELLA BRIANZA,161,19,180
2020-04-09,33,03017110,MONNO,BRESCIA,2,0,2
2020-04-09,34,03098037,MASSALENGO,LODI,24,2,26
2020-04-09,35,03016223,VALBONDIONE,BERGAMO,7,6,13
2020-04-09,36,03019079,RICENGO,CREMONA,10,0,10
2020-04-09,37,03017022,BORNO,BRESCIA,26,4,30
2020-04-09,38,03020022,DOSOLO,MANTOVA,18,10,28
2020-04-09,39,03014053,POSTALESIO,SONDRIO,1,1,2
2020-04-09,41,03016189,SAN PAOLO D`ARGON,BERGAMO,37,13,50
2020-04-09,42,03098008,CASALETTO LODIGIANO,LODI,7,1,8
2020-04-09,43,03018157,TORRE D`ARESE,PAVIA,1,1,2
2020-04-09,44,03015192,SAN DONATO MILANESE,MILANO,98,15,113
2020-04-09,45,03097075,SIRONE,LECCO,7,1,8
2020-04-09,46,03012127,TRADATE,VARESE,33,7,40
2020-04-09,47,03097018,CASSINA VALSASSINA,LECCO,2,0,2
2020-04-09,48,03018152,SPESSA,PAVIA,4,0,4
2020-04-09,1,03015074,CESANO BOSCONE,MILANO,121,12,133
2020-04-09,2,03017206,PIANCOGNO,BRESCIA,33,3,36
2020-04-09,3,03015200,SANTO STEFANO TICINO,MILANO,13,3,16
2020-04-09,4,03014021,CINO,SONDRIO,2,0,2
2020-04-09,5,03014013,CASPOGGIO,SONDRIO,10,3,13
2020-04-09,6,03012051,CITTIGLIO,VARESE,4,0,4
2020-04-09,7,03016030,BONATE SOPRA,BERGAMO,53,14,67
2020-04-09,8,03012108,OLGIATE OLONA,VARESE,23,4,27
2020-04-09,9,03016017,AZZONE,BERGAMO,2,0,2
2020-04-09,10,03018158,TORRE DE` NEGRI,PAVIA,2,1,3
2020-04-09,11,03015036,BUCCINASCO,MILANO,42,7,49
2020-04-09,12,03012141,SANGIANO,VARESE,2,0,2
2020-04-09,13,03016012,ARDESIO,BERGAMO,22,8,30
2020-04-09,14,03020060,SCHIVENOGLIA,MANTOVA,51,14,65
2020-04-09,15,03015236,VERNATE,MILANO,11,1,12
2020-04-09,16,03020017,CASTIGLIONE DELLE STIVIERE,MANTOVA,196,12,208
2020-04-09,17,03019110,TRIGOLO,CREMONA,51,7,58
2020-04-09,18,03015093,CORSICO,MILANO,66,14,80
2020-04-09,19,03012036,CASALE LITTA,VARESE,3,0,3
2020-04-09,20,03098026,FOMBIO,LODI,21,10,31
2020-04-09,21,03018110,PAVIA,PAVIA,304,51,355
2020-04-09,22,03017168,SABBIO CHIESE,BRESCIA,17,6,23
2020-04-09,23,03014077,VILLA DI CHIAVENNA,SONDRIO,2,1,3
2020-04-09,24,03108019,CESANO MADERNO,MONZA E DELLA BRIANZA,99,17,116
2020-04-09,25,03012081,GRANTOLA,VARESE,1,0,1
2020-04-09,27,03014069,TRAONA,SONDRIO,1,0,1
2020-04-09,28,03019032,CORTE DE` CORTESI CON CIGNONE,CREMONA,11,3,14
2020-04-09,52,03016037,BREMBATE,BERGAMO,39,18,57
2020-04-09,57,03018096,MONTECALVO VERSIGGIA,PAVIA,1,2,3
2020-04-09,58,03016075,CISERANO,BERGAMO,25,12,37
2020-04-09,59,03018184,ZAVATTARELLO,PAVIA,13,13,26
2020-04-09,60,03098052,SECUGNAGO,LODI,14,1,15
2020-04-09,64,03018090,MEZZANA BIGLI,PAVIA,2,1,3
2020-04-09,65,03013084,CUCCIAGO,COMO,4,2,6
2020-04-09,67,03015076,CESATE,MILANO,54,5,59
2020-04-09,68,03015005,ALBAIRATE,MILANO,4,0,4
2020-04-09,69,03019082,RIPALTA GUERINA,CREMONA,2,0,2
2020-04-09,70,03020012,CASALROMANO,MANTOVA,15,2,17
2020-04-09,71,03097051,MOLTENO,LECCO,7,1,8
2020-04-09,61,03018043,CERANOVA,PAVIA,5,3,8
2020-04-09,62,03016213,TERNO D`ISOLA,BERGAMO,49,7,56
2020-04-09,63,03015101,DRESANO,MILANO,15,5,20
2020-04-09,109,03017161,REZZATO,BRESCIA,78,17,95
2020-04-09,72,03016084,COSTA DI MEZZATE,BERGAMO,14,7,21
2020-04-09,73,03108004,ARCORE,MONZA E DELLA BRIANZA,69,15,84
2020-04-09,74,03020061,SERMIDE E FELONICA,MANTOVA,52,18,70
2020-04-09,75,03016136,MOIO DE` CALVI,BERGAMO,1,1,2
2020-04-09,76,03108009,BIASSONO,MONZA E DELLA BRIANZA,57,7,64
2020-04-09,77,03017196,VEROLAVECCHIA,BRESCIA,24,13,37
2020-04-09,78,03017031,CAINO,BRESCIA,7,1,8
2020-04-09,79,03097093,VALVARRONE,LECCO,3,1,4
2020-04-09,80,03019115,VOLTIDO,CREMONA,1,0,1
2020-04-09,81,03016123,LALLIO,BERGAMO,28,3,31
2020-04-09,82,03019096,SOLAROLO RAINERIO,CREMONA,9,4,13
2020-04-09,83,03013248,SAN SIRO,COMO,8,1,9
2020-04-09,84,03018160,TORREVECCHIA PIA,PAVIA,8,1,9
2020-04-09,85,03017135,PASPARDO,BRESCIA,2,1,3
2020-04-09,86,03020016,CASTELLUCCHIO,MANTOVA,13,1,14
2020-04-09,87,03097042,LECCO,LECCO,232,44,276
2020-04-09,88,03017152,PRALBOINO,BRESCIA,20,4,24
2020-04-09,89,03018007,BAGNARIA,PAVIA,1,0,1
2020-04-09,90,03020045,PORTO MANTOVANO,MANTOVA,30,4,34
2020-04-09,91,03016248,ALGUA,BERGAMO,5,1,6
2020-04-09,92,03017029,BRESCIA,BRESCIA,"1,230",285,"1,515"
2020-04-09,93,03016008,ALZANO LOMBARDO,BERGAMO,117,62,179
2020-04-09,94,03012125,TAINO,VARESE,3,0,3
2020-04-09,95,03017090,LODRINO,BRESCIA,8,4,12
2020-04-09,96,03012136,VENEGONO INFERIORE,VARESE,8,1,9
2020-04-09,98,03098010,CASALPUSTERLENGO,LODI,146,40,186
2020-04-09,99,03016139,MONTELLO,BERGAMO,20,8,28
2020-04-09,100,03017093,LONGHENA,BRESCIA,9,1,10
2020-04-09,101,03016184,RONCOBELLO,BERGAMO,1,0,1
2020-04-09,102,03019055,MADIGNANO,CREMONA,18,8,26
2020-04-09,103,03017073,GAMBARA,BRESCIA,27,2,29
2020-04-09,104,03098040,MONTANASO LOMBARDO,LODI,17,1,18
2020-04-09,105,03017111,MONTE ISOLA,BRESCIA,13,2,15
2020-04-09,106,03012027,CADEGLIANO - VICONAGO,VARESE,7,0,7
2020-04-09,107,03012071,GALLIATE LOMBARDO,VARESE,1,0,1
2020-04-09,108,03019010,CAMISANO,CREMONA,13,2,15
2020-04-09,49,03018175,VERRUA PO,PAVIA,2,4,6
2020-04-09,50,03017026,BRANDICO,BRESCIA,7,3,10
2020-04-09,51,03012002,ALBIZZATE,VARESE,6,1,7
2020-04-09,54,03016094,ENTRATICO,BERGAMO,9,3,12
2020-04-09,55,03017066,DELLO,BRESCIA,35,7,42
2020-04-09,56,03017189,TREMOSINE SUL GARDA,BRESCIA,2,2,4
2020-04-09,110,03016010,ANTEGNATE,BERGAMO,7,4,11
2020-04-09,111,03098030,LIVRAGA,LODI,16,8,24
2020-04-09,112,03108044,USMATE VELATE,MONZA E DELLA BRIANZA,20,4,24
2020-04-09,113,03014043,MESE,SONDRIO,3,0,3
2020-04-09,114,03013074,COLONNO,COMO,2,1,3
2020-04-09,115,03098005,BORGO SAN GIOVANNI,LODI,14,0,14
2020-04-09,116,03014037,LIVIGNO,SONDRIO,22,3,25
2020-04-09,117,03017099,MAIRANO,BRESCIA,14,2,16
2020-04-09,158,03016232,VERDELLINO,BERGAMO,46,13,59
2020-04-09,160,03017109,MONIGA DEL GARDA,BRESCIA,14,4,18
2020-04-09,164,03012131,VALGANNA,VARESE,1,0,1
2020-04-09,165,03018156,TORRE BERETTI E CASTELLARO,PAVIA,3,1,4
2020-04-09,166,03013154,MONTANO LUCINO,COMO,10,2,12
2020-04-09,167,03097083,VALMADRERA,LECCO,39,8,47
2020-04-09,169,03016149,ONORE,BERGAMO,11,2,13
2020-04-09,171,03016080,COLZATE,BERGAMO,14,7,21
2020-04-09,172,03013137,LURAGO MARINONE,COMO,3,0,3
2020-04-09,173,03017123,OME,BRESCIA,25,6,31
2020-04-09,118,03017008,AZZANO MELLA,BRESCIA,17,5,22
2020-04-09,119,03016002,ADRARA SAN ROCCO,BERGAMO,1,0,1
2020-04-09,120,03014009,BORMIO,SONDRIO,19,6,25
2020-04-09,121,03097026,COSTA MASNAGA,LECCO,18,6,24
2020-04-09,122,03016196,SEDRINA,BERGAMO,20,11,31
2020-04-09,123,03012090,LONATE POZZOLO,VARESE,17,0,17
2020-04-09,124,03012008,BARASSO,VARESE,1,0,1
2020-04-09,125,03017034,CALVISANO,BRESCIA,36,16,52
2020-04-09,126,03012107,OGGIONA CON SANTO STEFANO,VARESE,3,0,3
2020-04-09,127,03020070,VOLTA MANTOVANA,MANTOVA,91,14,105
2020-04-09,128,03016113,GHISALBA,BERGAMO,22,10,32
2020-04-09,129,03016237,VIGOLO,BERGAMO,7,3,10
2020-04-09,130,03108010,BOVISIO MASCIAGO,MONZA E DELLA BRIANZA,37,3,40
2020-04-09,131,03018034,CASORATE PRIMO,PAVIA,21,5,26
2020-04-09,132,03018003,ALBONESE,PAVIA,1,3,4
2020-04-09,134,03020044,PONTI SUL MINCIO,MANTOVA,5,0,5
2020-04-09,135,03097052,MONTE MARENZO,LECCO,4,1,5
2020-04-09,136,03097061,OSNAGO,LECCO,20,2,22
2020-04-09,137,03016219,TREVIGLIO,BERGAMO,170,43,213
2020-04-09,138,03013022,BEREGAZZO CON FIGLIARO,COMO,5,0,5
2020-04-09,139,03013110,GRANDATE,COMO,8,4,12
2020-04-09,140,03016049,CANONICA D`ADDA,BERGAMO,23,6,29
2020-04-09,141,03017015,BERLINGO,BRESCIA,18,5,23
2020-04-09,142,03015140,MELEGNANO,MILANO,108,28,136
2020-04-09,143,03019040,DEROVERE,CREMONA,1,0,1
2020-04-09,144,03017178,SERLE,BRESCIA,31,0,31
2020-04-09,145,03098045,PIEVE FISSIRAGA,LODI,8,4,12
2020-04-09,146,03015201,SAN VITTORE OLONA,MILANO,30,5,35
2020-04-09,147,03013128,LIMIDO COMASCO,COMO,3,0,3
2020-04-09,148,03013065,CERNOBBIO,COMO,13,2,15
2020-04-09,149,03020073,BORGOCARBONARA,MANTOVA,4,1,5
2020-04-09,150,03012033,CARNAGO,VARESE,4,0,4
2020-04-09,152,03013143,MARIANO COMENSE,COMO,49,13,62
2020-04-09,153,03018077,INVERNO E MONTELEONE,PAVIA,6,0,6
2020-04-09,154,03013253,ALTA VALLE INTELVI,COMO,2,1,3
2020-04-09,159,03019093,SCANDOLARA RIPA D`OGLIO,CREMONA,8,1,9
2020-04-09,161,03015082,COLTURANO,MILANO,3,2,5
2020-04-09,162,03017007,ARTOGNE,BRESCIA,34,2,36
2020-04-09,163,03016179,RANZANICO,BERGAMO,15,4,19
2020-04-09,156,03013043,CAPIAGO INTIMIANO,COMO,10,2,12
2020-04-09,157,03019089,SAN DANIELE PO,CREMONA,17,2,19
2020-04-09,180,03016239,VILLA D`ALME`,BERGAMO,51,20,71
2020-04-09,181,03017176,SELLERO,BRESCIA,8,3,11
2020-04-09,182,03013203,SALA COMACINA,COMO,11,4,15
2020-04-09,183,03016201,SONGAVAZZO,BERGAMO,12,3,15
2020-04-09,184,03018189,ZERBOLO`,PAVIA,6,0,6
2020-04-09,185,03097033,ELLO,LECCO,4,2,6
2020-04-09,186,03016034,BOTTANUCO,BERGAMO,25,8,33
2020-04-09,187,03018087,MARZANO,PAVIA,6,2,8
2020-04-09,188,03018040,CASTELNOVETTO,PAVIA,1,0,1
2020-04-09,189,03015169,PAULLO,MILANO,60,14,74
2020-04-09,190,03013234,VALSOLDA,COMO,4,0,4
2020-04-09,191,03016174,PREDORE,BERGAMO,14,7,21
2020-04-09,192,03017179,SIRMIONE,BRESCIA,41,7,48
2020-04-09,193,03019094,SERGNANO,CREMONA,47,8,55
2020-04-09,194,03018107,PALESTRO,PAVIA,2,0,2
2020-04-09,195,03013211,SCHIGNANO,COMO,1,0,1
2020-04-09,196,03016119,GRONE,BERGAMO,6,2,8
2020-04-09,197,03019027,CASTELVISCONTI,CREMONA,1,0,1
2020-04-09,198,03018155,TORRAZZA COSTE,PAVIA,5,5,10
2020-04-09,199,03098039,MERLINO,LODI,4,1,5
2020-04-09,200,03019053,ISOLA DOVARESE,CREMONA,11,2,13
2020-04-09,201,03019009,CALVATONE,CREMONA,11,3,14
2020-04-09,202,03018009,BASCAPE`,PAVIA,6,1,7
2020-04-09,203,03018150,SIZIANO,PAVIA,16,5,21
2020-04-09,204,03017162,ROCCAFRANCA,BRESCIA,28,9,37
2020-04-09,205,03016074,CISANO BERGAMASCO,BERGAMO,33,12,45
2020-04-09,206,03018060,CURA CARPIGNANO,PAVIA,19,4,23
2020-04-09,207,03098025,CRESPIATICA,LODI,8,4,12
2020-04-09,208,03020032,MARIANA MANTOVANA,MANTOVA,3,1,4
2020-04-09,209,03016191,SANTA BRIGIDA,BERGAMO,4,3,7
2020-04-09,210,03013163,NOVEDRATE,COMO,3,0,3
2020-04-09,211,03017092,LONATO DEL GARDA,BRESCIA,111,14,125
2020-04-09,212,03020002,ASOLA,MANTOVA,72,15,87
2020-04-09,214,03018086,MARCIGNAGO,PAVIA,8,0,8
2020-04-09,215,03017042,CASTEL MELLA,BRESCIA,69,11,80
2020-04-09,213,03012057,CROSIO DELLA VALLE,VARESE,1,0,1
2020-04-09,216,03015051,CARUGATE,MILANO,61,12,73
2020-04-09,217,03019002,AGNADELLO,CREMONA,29,8,37
2020-04-09,218,03016165,PIAZZATORRE,BERGAMO,3,1,4
2020-04-09,219,03017077,GAVARDO,BRESCIA,90,14,104
2020-04-09,220,03014006,BEMA,SONDRIO,0,1,1
2020-04-09,221,03019038,CROTTA D`ADDA,CREMONA,9,3,12
2020-04-09,222,03015206,SENAGO,MILANO,44,16,60
2020-04-09,223,03012138,VERGIATE,VARESE,13,3,16
2020-04-09,225,03013075,COMO,COMO,181,51,232
2020-04-09,227,03012025,BUGUGGIATE,VARESE,1,0,1
2020-04-09,228,03016040,BRIGNANO GERA D`ADDA,BERGAMO,25,12,37
2020-04-09,229,03016029,BOLTIERE,BERGAMO,25,15,40
2020-04-09,230,03019078,QUINTANO,CREMONA,10,4,14
2020-04-09,231,03012074,GEMONIO,VARESE,2,0,2
2020-04-09,232,03020001,ACQUANEGRA SUL CHIESE,MANTOVA,26,2,28
2020-04-09,233,03018071,GERENZAGO,PAVIA,8,2,10
2020-04-09,234,03015014,BASIANO,MILANO,8,7,15
2020-04-09,235,03015078,CISLIANO,MILANO,12,2,14
2020-04-09,236,03017065,DARFO BOARIO TERME,BRESCIA,107,19,126
2020-04-09,237,03012004,ARCISATE,VARESE,14,2,16
2020-04-09,174,03013114,GUANZATE,COMO,8,0,8
2020-04-09,175,03016101,FONTANELLA,BERGAMO,18,5,23
2020-04-09,176,03097036,GALBIATE,LECCO,47,11,58
2020-04-09,178,03015108,GORGONZOLA,MILANO,77,8,85
2020-04-09,179,03018024,BRONI,PAVIA,51,14,65
2020-04-09,239,03016242,VILLONGO,BERGAMO,33,16,49
2020-04-09,240,03097009,BOSISIO PARINI,LECCO,14,1,15
2020-04-09,268,03017120,NUVOLERA,BRESCIA,34,3,37
2020-04-09,269,03016098,FILAGO,BERGAMO,18,7,25
2020-04-09,272,03012137,VENEGONO SUPERIORE,VARESE,6,1,7
2020-04-09,273,03015250,BARANZATE,MILANO,34,2,36
2020-04-09,274,03016209,SUISIO,BERGAMO,25,7,32
2020-04-09,275,03015157,NOVATE MILANESE,MILANO,72,7,79
2020-04-09,276,03016051,CAPRIATE SAN GERVASIO,BERGAMO,61,21,82
2020-04-09,277,03013087,DIZZASCO,COMO,0,4,4
2020-04-09,241,03017192,URAGO D`OGLIO,BRESCIA,27,5,32
2020-04-09,242,03017013,BASSANO BRESCIANO,BRESCIA,20,3,23
2020-04-09,243,03017079,GIANICO,BRESCIA,24,5,29
2020-04-09,244,03018192,CORTEOLONA E GENZONE,PAVIA,11,3,14
2020-04-09,245,03015210,SETTALA,MILANO,19,5,24
2020-04-09,246,03017004,ALFIANELLO,BRESCIA,28,7,35
2020-04-09,247,03016204,SOVERE,BERGAMO,34,8,42
2020-04-09,248,03017173,SAN ZENO NAVIGLIO,BRESCIA,28,6,34
2020-04-09,249,03016175,PREMOLO,BERGAMO,10,5,15
2020-04-09,251,03017002,ADRO,BRESCIA,50,17,67
2020-04-09,252,03018085,MAGHERNO,PAVIA,2,5,7
2020-04-09,253,03020041,PIUBEGA,MANTOVA,5,3,8
2020-04-09,254,03013239,VERCANA,COMO,1,0,1
2020-04-09,255,03018117,PONTE NIZZA,PAVIA,10,2,12
2020-04-09,256,03015146,MILANO,MILANO,"4,323",656,"4,979"
2020-04-09,257,03016041,BRUMANO,BERGAMO,1,0,1
2020-04-09,258,03017064,CORZANO,BRESCIA,20,4,24
2020-04-09,259,03018039,CASTELLO D`AGOGNA,PAVIA,1,1,2
2020-04-09,260,03016183,ROMANO DI LOMBARDIA,BERGAMO,108,47,155
2020-04-09,261,03012022,BRISSAGO - VALTRAVAGLIA,VARESE,1,0,1
2020-04-09,262,03012010,BEDERO VALCUVIA,VARESE,1,0,1
2020-04-09,263,03019013,CAPPELLA CANTONE,CREMONA,8,2,10
2020-04-09,264,03098038,MELETI,LODI,13,5,18
2020-04-09,265,03016166,PIAZZOLO,BERGAMO,0,1,1
2020-04-09,270,03017199,VILLA CARCINA,BRESCIA,82,8,90
2020-04-09,271,03013228,UGGIATE - TREVANO,COMO,3,2,5
2020-04-09,266,03017060,COMEZZANO - CIZZAGO,BRESCIA,23,5,28
2020-04-09,267,03019037,CREMOSANO,CREMONA,7,5,12
2020-04-09,288,03015194,SAN GIORGIO SU LEGNANO,MILANO,12,3,15
2020-04-09,291,03015040,BUSSERO,MILANO,26,4,30
2020-04-09,294,03012054,COMABBIO,VARESE,1,0,1
2020-04-09,296,03015165,OZZERO,MILANO,7,2,9
2020-04-09,297,03016068,CENATE SOPRA,BERGAMO,14,6,20
2020-04-09,298,03018142,SANTA MARGHERITA DI STAFFORA,PAVIA,1,1,2
2020-04-09,299,03017081,GUSSAGO,BRESCIA,125,30,155
2020-04-09,300,03013161,NESSO,COMO,2,0,2
2020-04-09,301,03017190,TRENZANO,BRESCIA,35,9,44
2020-04-09,329,03108052,CAPONAGO,MONZA E DELLA BRIANZA,22,4,26
2020-04-09,330,03017132,PAITONE,BRESCIA,10,1,11
2020-04-09,338,03017030,BRIONE,BRESCIA,4,1,5
2020-04-09,339,03019070,PESSINA CREMONESE,CREMONA,2,0,2
2020-04-09,340,03012005,ARSAGO SEPRIO,VARESE,12,0,12
2020-04-09,341,03016011,ARCENE,BERGAMO,41,7,48
2020-04-09,589,03016253,VAL BREMBILLA,BERGAMO,33,9,42
2020-04-09,590,03019076,PIZZIGHETTONE,CREMONA,60,25,85
2020-04-09,302,03012039,CASORATE SEMPIONE,VARESE,8,1,9
2020-04-09,303,03019039,CUMIGNANO SUL NAVIGLIO,CREMONA,6,0,6
2020-04-09,304,03108042,SULBIATE,MONZA E DELLA BRIANZA,11,0,11
2020-04-09,305,03012077,GOLASECCA,VARESE,3,1,4
2020-04-09,306,03098027,GALGAGNANO,LODI,8,4,12
2020-04-09,307,03016172,PONTIROLO NUOVO,BERGAMO,29,8,37
2020-04-09,308,03013178,PEGLIO,COMO,1,0,1
2020-04-09,309,03015114,INZAGO,MILANO,72,7,79
2020-04-09,310,03012044,CASTELSEPRIO,VARESE,0,1,1
2020-04-09,311,03019069,PESCAROLO ED UNITI,CREMONA,15,2,17
2020-04-09,312,03098006,BREMBIO,LODI,16,8,24
2020-04-09,313,03019097,SONCINO,CREMONA,60,11,71
2020-04-09,314,03018128,ROMAGNESE,PAVIA,7,2,9
2020-04-09,316,03108029,MACHERIO,MONZA E DELLA BRIANZA,17,8,25
2020-04-09,317,03016159,PARZANICA,BERGAMO,1,0,1
2020-04-09,318,03019021,CASALMAGGIORE,CREMONA,79,18,97
2020-04-09,319,03014072,VALDISOTTO,SONDRIO,14,2,16
2020-04-09,320,03013183,PIANELLO DEL LARIO,COMO,0,3,3
2020-04-09,321,03014025,DAZIO,SONDRIO,2,0,2
2020-04-09,322,03017063,CORTENO GOLGI,BRESCIA,14,2,16
2020-04-09,323,03012015,BISUSCHIO,VARESE,3,1,4
2020-04-09,326,03018123,ROBBIO,PAVIA,11,5,16
2020-04-09,327,03016144,NEMBRO,BERGAMO,130,83,213
2020-04-09,328,03014004,APRICA,SONDRIO,2,3,5
2020-04-09,331,03017074,GARDONE RIVIERA,BRESCIA,19,2,21
2020-04-09,332,03016057,CARVICO,BERGAMO,16,13,29
2020-04-09,333,03013100,FENEGRO`,COMO,4,0,4
2020-04-09,334,03016194,SCANZOROSCIATE,BERGAMO,58,21,79
2020-04-09,324,03015110,GREZZAGO,MILANO,9,3,12
2020-04-09,325,03017001,ACQUAFREDDA,BRESCIA,13,7,20
2020-04-09,335,03097049,MISSAGLIA,LECCO,20,8,28
2020-04-09,336,03108047,VEDUGGIO CON COLZANO,MONZA E DELLA BRIANZA,23,3,26
2020-04-09,337,03016147,OLTRESSENDA ALTA,BERGAMO,1,0,1
2020-04-09,278,03013250,BELLAGIO,COMO,12,4,16
2020-04-09,279,03019006,BONEMERSE,CREMONA,32,3,35
2020-04-09,280,03015131,MAGNAGO,MILANO,12,3,15
2020-04-09,281,03019044,FORMIGARA,CREMONA,5,2,7
2020-04-09,282,03016072,CHIGNOLO D`ISOLA,BERGAMO,17,8,25
2020-04-09,283,03018119,REA,PAVIA,1,0,1
2020-04-09,285,03013223,TORNO,COMO,5,2,7
2020-04-09,286,03012105,MORAZZONE,VARESE,4,1,5
2020-04-09,287,03013010,APPIANO GENTILE,COMO,8,2,10
2020-04-09,289,03018027,CANDIA LOMELLINA,PAVIA,5,3,8
2020-04-09,290,03018111,PIETRA DE` GIORGI,PAVIA,7,0,7
2020-04-09,292,03017191,TREVISO BRESCIANO,BRESCIA,6,1,7
2020-04-09,293,03014054,PRATA CAMPORTACCIO,SONDRIO,3,1,4
2020-04-09,342,03016096,FARA GERA D`ADDA,BERGAMO,25,8,33
2020-04-09,343,03017175,SAVIORE DELL`ADAMELLO,BRESCIA,6,1,7
2020-04-09,345,03020037,MOTTEGGIANA,MANTOVA,5,1,6
2020-04-09,346,03020053,ROVERBELLA,MANTOVA,11,3,14
2020-04-09,347,03012103,MONTEGRINO VALTRAVAGLIA,VARESE,1,1,2
2020-04-09,348,03018159,TORRE D`ISOLA,PAVIA,10,0,10
2020-04-09,349,03015113,INVERUNO,MILANO,39,7,46
2020-04-09,350,03019015,CAPRALBA,CREMONA,8,4,12
2020-04-09,351,03108005,BARLASSINA,MONZA E DELLA BRIANZA,14,2,16
2020-04-09,352,03016078,COLERE,BERGAMO,10,3,13
2020-04-09,353,03098061,ZELO BUON PERSICO,LODI,22,7,29
2020-04-09,354,03018088,MEDE,PAVIA,11,3,14
2020-04-09,357,03016099,FINO DEL MONTE,BERGAMO,5,5,10
2020-04-09,355,03019054,IZANO,CREMONA,19,1,20
2020-04-09,356,03017116,MUSCOLINE,BRESCIA,11,1,12
2020-04-09,456,03108033,MONZA,MONZA E DELLA BRIANZA,554,89,643
2020-04-09,457,03016246,ZOGNO,BERGAMO,102,35,137
2020-04-09,458,03018141,SANT`ALESSIO CON VIALONE,PAVIA,3,1,4
2020-04-09,459,03016227,VALNEGRA,BERGAMO,3,0,3
2020-04-09,460,03108011,BRIOSCO,MONZA E DELLA BRIANZA,11,3,14
2020-04-09,461,03097074,SANTA MARIA HOE`,LECCO,11,2,13
2020-04-09,359,03017105,MARMENTINO,BRESCIA,2,0,2
2020-04-09,360,03017017,BERZO INFERIORE,BRESCIA,14,1,15
2020-04-09,361,03098013,CASTELNUOVO BOCCA D`ADDA,LODI,28,7,35
2020-04-09,362,03015071,CERRO AL LAMBRO,MILANO,16,1,17
2020-04-09,363,03016081,COMUN NUOVO,BERGAMO,18,7,25
2020-04-09,364,03017131,PAISCO LOVENO,BRESCIA,2,0,2
2020-04-09,365,03016182,ROGNO,BERGAMO,26,9,35
2020-04-09,366,03013222,TAVERNERIO,COMO,18,2,20
2020-04-09,368,03016146,OLTRE IL COLLE,BERGAMO,8,2,10
2020-04-09,369,03016090,CUSIO,BERGAMO,2,0,2
2020-04-09,370,03016177,PUMENENGO,BERGAMO,10,3,13
2020-04-09,371,03097007,BARZIO,LECCO,6,2,8
2020-04-09,372,03020051,RODIGO,MANTOVA,25,4,29
2020-04-09,373,03016043,CALCINATE,BERGAMO,34,9,43
2020-04-09,374,03020042,POGGIO RUSCO,MANTOVA,28,6,34
2020-04-09,375,03015072,CERRO MAGGIORE,MILANO,46,4,50
2020-04-09,376,03016214,TORRE BOLDONE,BERGAMO,72,34,106
2020-04-09,377,03019014,CAPPELLA DE` PICENARDI,CREMONA,2,1,3
2020-04-09,378,03018147,SCALDASOLE,PAVIA,2,0,2
2020-04-09,379,03013242,VERTEMATE CON MINOPRIO,COMO,9,1,10
2020-04-09,380,03020024,GAZOLDO DEGLI IPPOLITI,MANTOVA,16,4,20
2020-04-09,381,03016225,VALGOGLIO,BERGAMO,3,2,5
2020-04-09,382,03014074,VAL MASINO,SONDRIO,1,1,2
2020-04-09,383,03014024,COSIO VALTELLINO,SONDRIO,12,2,14
2020-04-09,384,03012085,JERAGO CON ORAGO,VARESE,9,0,9
2020-04-09,385,03016053,CARAVAGGIO,BERGAMO,84,35,119
2020-04-09,386,03017044,CASTO,BRESCIA,13,3,16
2020-04-09,387,03018033,CASEI GEROLA,PAVIA,14,9,23
2020-04-09,388,03012095,MALGESSO,VARESE,2,0,2
2020-04-09,390,03017018,BIENNO,BRESCIA,31,5,36
2020-04-09,391,03015115,LACCHIARELLA,MILANO,14,4,18
2020-04-09,392,03097010,BRIVIO,LECCO,45,10,55
2020-04-09,389,03108025,LAZZATE,MONZA E DELLA BRIANZA,21,3,24
2020-04-09,394,03018181,VISTARINO,PAVIA,5,0,5
2020-04-09,395,03108026,LESMO,MONZA E DELLA BRIANZA,38,4,42
2020-04-09,396,03016216,TORRE DE` ROVERI,BERGAMO,13,2,15
2020-04-09,397,03015219,TREZZANO ROSA,MILANO,15,2,17
2020-04-09,398,03016085,COSTA VALLE IMAGNA,BERGAMO,4,1,5
2020-04-09,399,03018020,BOSNASCO,PAVIA,3,0,3
2020-04-09,400,03014007,BERBENNO DI VALTELLINA,SONDRIO,16,0,16
2020-04-09,401,03108023,DESIO,MONZA E DELLA BRIANZA,127,14,141
2020-04-09,454,03016155,PALADINA,BERGAMO,41,20,61
2020-04-09,462,03098032,LODI VECCHIO,LODI,38,13,51
2020-04-09,463,03098014,CASTIGLIONE D`ADDA,LODI,139,48,187
2020-04-09,464,03014010,BUGLIO IN MONTE,SONDRIO,2,0,2
2020-04-09,465,03013232,VALMOREA,COMO,5,2,7
2020-04-09,466,03018101,MORNICO LOSANA,PAVIA,1,1,2
2020-04-09,467,03019111,VAIANO CREMASCO,CREMONA,24,10,34
2020-04-09,402,03017056,COCCAGLIO,BRESCIA,67,16,83
2020-04-09,403,03016124,LEFFE,BERGAMO,28,20,48
2020-04-09,404,03016169,PONTERANICA,BERGAMO,47,13,60
2020-04-09,405,03015059,CASSANO D`ADDA,MILANO,85,19,104
2020-04-09,406,03018193,COLLI VERDI,PAVIA,2,0,2
2020-04-09,407,03017101,MALONNO,BRESCIA,30,3,33
2020-04-09,408,03015188,ROSATE,MILANO,16,2,18
2020-04-09,409,03098055,SORDIO,LODI,24,11,35
2020-04-09,410,03017121,ODOLO,BRESCIA,7,1,8
2020-04-09,411,03017155,PREVALLE,BRESCIA,23,5,28
2020-04-09,412,03015032,BRESSO,MILANO,186,37,223
2020-04-09,413,03016215,TORRE DE` BUSI,BERGAMO,11,0,11
2020-04-09,414,03016226,VALLEVE,BERGAMO,1,0,1
2020-04-09,415,03015142,MELZO,MILANO,73,13,86
2020-04-09,416,03097054,MONTICELLO BRIANZA,LECCO,18,1,19
2020-04-09,417,03016167,POGNANO,BERGAMO,10,4,14
2020-04-09,418,03016200,SOLTO COLLINA,BERGAMO,9,5,14
2020-04-09,419,03018138,SANNAZZARO DE` BURGONDI,PAVIA,23,7,30
2020-04-09,420,03017170,SALO`,BRESCIA,60,10,70
2020-04-09,422,03014015,CASTIONE ANDEVENNO,SONDRIO,4,1,5
2020-04-09,423,03018174,VERRETTO,PAVIA,0,3,3
2020-04-09,424,03108006,BELLUSCO,MONZA E DELLA BRIANZA,35,13,48
2020-04-09,425,03018166,VAL DI NIZZA,PAVIA,2,0,2
2020-04-09,426,03013238,VENIANO,COMO,2,0,2
2020-04-09,427,03017027,BRAONE,BRESCIA,4,1,5
2020-04-09,428,03016047,CALVENZANO,BERGAMO,28,13,41
2020-04-09,429,03013129,LIPOMO,COMO,15,3,18
2020-04-09,430,03016023,BERBENNO,BERGAMO,19,1,20
2020-04-09,432,03012130,UBOLDO,VARESE,10,1,11
2020-04-09,433,03017059,COLOGNE,BRESCIA,40,13,53
2020-04-09,434,03013006,ALSERIO,COMO,3,0,3
2020-04-09,435,03017165,RONCADELLE,BRESCIA,63,19,82
2020-04-09,436,03108014,CAMPARADA,MONZA E DELLA BRIANZA,2,0,2
2020-04-09,437,03013106,GARZENO,COMO,3,2,5
2020-04-09,438,03018052,CONFIENZA,PAVIA,2,4,6
2020-04-09,439,03013123,LASNIGO,COMO,2,0,2
2020-04-09,440,03013101,FIGINO SERENZA,COMO,7,4,11
2020-04-09,441,03016137,MONASTEROLO DEL CASTELLO,BERGAMO,6,1,7
2020-04-09,442,03098047,SAN FIORANO,LODI,19,7,26
2020-04-09,444,03020039,PEGOGNAGA,MANTOVA,40,11,51
2020-04-09,446,03097023,COLICO,LECCO,16,2,18
2020-04-09,447,03098017,CAVENAGO D`ADDA,LODI,14,2,16
2020-04-09,448,03014027,DUBINO,SONDRIO,12,0,12
2020-04-09,449,03012110,ORINO,VARESE,1,0,1
2020-04-09,450,03108032,MISINTO,MONZA E DELLA BRIANZA,10,2,12
2020-04-09,451,03019066,PALAZZO PIGNANO,CREMONA,17,3,20
2020-04-09,452,03014070,TRESIVIO,SONDRIO,3,2,5
2020-04-09,453,03019100,SPINADESCO,CREMONA,20,2,22
2020-04-09,455,03016007,ALMENNO SAN SALVATORE,BERGAMO,38,11,49
2020-04-09,468,03012009,BARDELLO,VARESE,2,0,2
2020-04-09,469,03018186,ZEME,PAVIA,7,6,13
2020-04-09,470,03013107,GERA LARIO,COMO,3,0,3
2020-04-09,471,03013015,BARNI,COMO,2,0,2
2020-04-09,472,03013152,MOLTRASIO,COMO,1,0,1
2020-04-09,473,03017057,COLLEBEATO,BRESCIA,22,6,28
2020-04-09,536,03017011,BARBARIGA,BRESCIA,27,14,41
2020-04-09,537,03015016,BELLINZAGO LOMBARDO,MILANO,8,3,11
2020-04-09,474,03018118,PORTALBERA,PAVIA,7,2,9
2020-04-09,475,03019035,CREMA,CREMONA,356,105,461
2020-04-09,476,03012026,BUSTO ARSIZIO,VARESE,133,19,152
2020-04-09,477,03012088,LEGGIUNO,VARESE,5,0,5
2020-04-09,478,03018048,CHIGNOLO PO,PAVIA,33,6,39
2020-04-09,479,03108027,LIMBIATE,MONZA E DELLA BRIANZA,118,9,127
2020-04-09,480,03015185,RODANO,MILANO,12,3,15
2020-04-09,481,03017143,PISOGNE,BRESCIA,60,13,73
2020-04-09,482,03016104,FORESTO SPARSO,BERGAMO,15,9,24
2020-04-09,484,03018046,CERTOSA DI PAVIA,PAVIA,28,3,31
2020-04-09,485,03014044,MONTAGNA IN VALTELLINA,SONDRIO,8,3,11
2020-04-09,486,03017103,MANERBIO,BRESCIA,131,38,169
2020-04-09,487,03015061,CASSINETTA DI LUGAGNANO,MILANO,6,0,6
2020-04-09,488,03016229,VALTORTA,BERGAMO,0,2,2
2020-04-09,489,03012113,PORTO CERESIO,VARESE,1,1,2
2020-04-09,490,03015244,VIZZOLO PREDABISSI,MILANO,32,12,44
2020-04-09,491,03097015,CASARGO,LECCO,3,0,3
2020-04-09,493,03018139,SANTA CRISTINA E BISSONE,PAVIA,14,5,19
2020-04-09,494,03016244,ZANDOBBIO,BERGAMO,18,5,23
2020-04-09,492,03017188,TRAVAGLIATO,BRESCIA,79,11,90
2020-04-09,495,03098003,BOFFALORA D`ADDA,LODI,9,2,11
2020-04-09,496,03013201,ROVELLASCA,COMO,10,3,13
2020-04-09,497,03015085,CORBETTA,MILANO,56,8,64
2020-04-09,498,03019113,VESCOVATO,CREMONA,30,9,39
2020-04-09,500,03014067,TORRE DI SANTA MARIA,SONDRIO,1,0,1
2020-04-09,501,03017094,LOSINE,BRESCIA,2,0,2
2020-04-09,502,03012040,CASSANO MAGNAGO,VARESE,33,4,37
2020-04-09,503,03097092,LA VALLETTA BRIANZA,LECCO,19,6,25
2020-04-09,504,03014060,SONDALO,SONDRIO,17,2,19
2020-04-09,505,03098002,BERTONICO,LODI,3,0,3
2020-04-09,506,03012073,GAZZADA SCHIANNO,VARESE,8,0,8
2020-04-09,507,03018109,PARONA,PAVIA,8,5,13
2020-04-09,508,03015170,PERO,MILANO,38,5,43
2020-04-09,509,03014075,VERCEIA,SONDRIO,5,2,7
2020-04-09,510,03012070,GALLARATE,VARESE,80,6,86
2020-04-09,511,03098024,CORTE PALASIO,LODI,10,2,12
2020-04-09,512,03098031,LODI,LODI,359,100,459
2020-04-09,514,03098018,CERVIGNANO D`ADDA,LODI,15,7,22
2020-04-09,513,03017201,VILLANUOVA SUL CLISI,BRESCIA,43,10,53
2020-04-09,515,03016193,SARNICO,BERGAMO,29,14,43
2020-04-09,516,03017053,CIGOLE,BRESCIA,22,7,29
2020-04-09,518,03013032,BRUNATE,COMO,4,3,7
2020-04-09,519,03019065,PADERNO PONCHIELLI,CREMONA,16,3,19
2020-04-09,520,03017169,SALE MARASINO,BRESCIA,15,5,20
2020-04-09,521,03019059,MONTODINE,CREMONA,37,6,43
2020-04-09,517,03097034,ERVE,LECCO,3,0,3
2020-04-09,522,03012091,LOZZA,VARESE,1,1,2
2020-04-09,524,03018177,VIGEVANO,PAVIA,267,77,344
2020-04-09,525,03017141,PEZZAZE,BRESCIA,11,2,13
2020-04-09,526,03097059,OLGINATE,LECCO,36,4,40
2020-04-09,527,03097071,ROBBIATE,LECCO,31,4,35
2020-04-09,529,03018078,LANDRIANO,PAVIA,14,6,20
2020-04-09,530,03017038,CAPRIOLO,BRESCIA,64,23,87
2020-04-09,531,03018135,SAN GENESIO ED UNITI,PAVIA,8,1,9
2020-04-09,532,03017087,LAVENONE,BRESCIA,2,0,2
2020-04-09,533,03020007,BOZZOLO,MANTOVA,26,1,27
2020-04-09,534,03020068,VILLIMPENTA,MANTOVA,2,2,4
2020-04-09,535,03017080,GOTTOLENGO,BRESCIA,40,16,56
2020-04-09,538,03018072,GIUSSAGO,PAVIA,9,3,12
2020-04-09,580,03014002,ALBOSAGGIA,SONDRIO,5,0,5
2020-04-09,581,03018103,NICORVO,PAVIA,1,1,2
2020-04-09,578,03015167,PANTIGLIATE,MILANO,32,8,40
2020-04-09,582,03018130,ROSASCO,PAVIA,1,0,1
2020-04-09,583,03098054,SOMAGLIA,LODI,23,6,29
2020-04-09,584,03017032,CALCINATO,BRESCIA,69,10,79
2020-04-09,585,03012012,BESNATE,VARESE,5,2,7
2020-04-09,586,03015041,BUSTO GAROLFO,MILANO,38,1,39
2020-04-09,587,03016006,ALMENNO SAN BARTOLOMEO,BERGAMO,35,8,43
2020-04-09,588,03020013,CASTELBELFORTE,MANTOVA,8,0,8
2020-04-09,539,03018091,MEZZANA RABATTONE,PAVIA,2,0,2
2020-04-09,540,03018018,BORGO SAN SIRO,PAVIA,4,2,6
2020-04-09,541,03013144,MASLIANICO,COMO,3,2,5
2020-04-09,542,03016154,PAGAZZANO,BERGAMO,9,2,11
2020-04-09,543,03098049,SAN ROCCO AL PORTO,LODI,34,15,49
2020-04-09,544,03020056,SAN GIACOMO DELLE SEGNATE,MANTOVA,4,2,6
2020-04-09,545,03012133,VARESE,VARESE,121,20,141
2020-04-09,546,03017009,BAGNOLO MELLA,BRESCIA,119,20,139
2020-04-09,547,03097039,IMBERSAGO,LECCO,12,4,16
2020-04-09,548,03016122,ISSO,BERGAMO,1,0,1
2020-04-09,549,03017096,LUMEZZANE,BRESCIA,88,23,111
2020-04-09,550,03108046,VEDANO AL LAMBRO,MONZA E DELLA BRIANZA,37,8,45
2020-04-09,551,03015175,PIOLTELLO,MILANO,172,26,198
2020-04-09,552,03012068,FERNO,VARESE,18,2,20
2020-04-09,553,03016083,CORTENUOVA,BERGAMO,11,7,18
2020-04-09,554,03016206,SPIRANO,BERGAMO,37,10,47
2020-04-09,555,03012083,INDUNO OLONA,VARESE,7,2,9
2020-04-09,556,03016188,SAN GIOVANNI BIANCO,BERGAMO,42,17,59
2020-04-09,557,03098021,CORNEGLIANO LAUDENSE,LODI,19,4,23
2020-04-09,558,03016073,CHIUDUNO,BERGAMO,37,11,48
2020-04-09,559,03017149,PONTEVICO,BRESCIA,69,18,87
2020-04-09,560,03015009,ARESE,MILANO,39,9,48
2020-04-09,561,03016211,TAVERNOLA BERGAMASCA,BERGAMO,15,5,20
2020-04-09,562,03015144,MESERO,MILANO,24,4,28
2020-04-09,563,03019108,TORRICELLA DEL PIZZO,CREMONA,5,1,6
2020-04-09,565,03019091,SAN MARTINO DEL LAGO,CREMONA,3,0,3
2020-04-09,566,03097090,VIGANO`,LECCO,15,2,17
2020-04-09,567,03014061,SONDRIO,SONDRIO,89,9,98
2020-04-09,568,03012013,BESOZZO,VARESE,9,1,10
2020-04-09,569,03014063,TALAMONA,SONDRIO,15,6,21
2020-04-09,570,03013249,GRAVEDONA ED UNITI,COMO,30,4,34
2020-04-09,571,03018173,VELLEZZO BELLINI,PAVIA,22,2,24
2020-04-09,572,03019104,TICENGO,CREMONA,3,2,5
2020-04-09,573,03016019,BARBATA,BERGAMO,4,0,4
2020-04-09,574,03015172,PESSANO CON BORNAGO,MILANO,74,8,82
2020-04-09,575,03018075,GRAVELLONA LOMELLINA,PAVIA,12,4,16
2020-04-09,577,03015204,SEDRIANO,MILANO,42,11,53
2020-04-09,591,03019072,PIANENGO,CREMONA,27,3,30
2020-04-09,592,03017054,CIMBERGO,BRESCIA,2,0,2
2020-04-09,593,03018153,STRADELLA,PAVIA,55,13,68
2020-04-09,594,03014012,CAMPODOLCINO,SONDRIO,2,1,3
2020-04-09,595,03017138,SAN PAOLO,BRESCIA,51,13,64
2020-04-09,725,03016093,ENDINE GAIANO,BERGAMO,21,9,30
2020-04-09,726,03017137,PAVONE DEL MELLA,BRESCIA,25,13,38
2020-04-09,727,03016058,CASAZZA,BERGAMO,35,4,39
2020-04-09,728,03016021,BARZANA,BERGAMO,12,5,17
2020-04-09,729,03018134,SAN DAMIANO AL COLLE,PAVIA,5,1,6
2020-04-09,730,03017194,VALVESTINO,BRESCIA,2,0,2
2020-04-09,731,03012143,CADREZZATE CON OSMATE,VARESE,3,1,4
2020-04-09,732,03019047,GENIVOLTA,CREMONA,8,0,8
2020-04-09,733,03017197,VESTONE,BRESCIA,51,5,56
2020-04-09,734,03016025,BERZO SAN FERMO,BERGAMO,9,7,16
2020-04-09,736,03018036,CASTANA,PAVIA,6,2,8
2020-04-09,737,03019022,CASALMORANO,CREMONA,23,5,28
2020-04-09,738,03012089,LONATE CEPPINO,VARESE,9,2,11
2020-04-09,596,03018188,ZERBO,PAVIA,1,1,2
2020-04-09,597,03020029,MAGNACAVALLO,MANTOVA,3,3,6
2020-04-09,598,03014036,LANZADA,SONDRIO,8,1,9
2020-04-09,599,03017151,POZZOLENGO,BRESCIA,13,5,18
2020-04-09,600,03017156,PROVAGLIO D`ISEO,BRESCIA,56,16,72
2020-04-09,601,03017072,FLERO,BRESCIA,40,9,49
2020-04-09,602,03015105,GARBAGNATE MILANESE,MILANO,141,16,157
2020-04-09,603,03015221,TREZZO SULL`ADDA,MILANO,97,27,124
2020-04-09,604,03019074,PIEVE D`OLMI,CREMONA,16,2,18
2020-04-09,605,03019084,RIVOLTA D`ADDA,CREMONA,69,13,82
2020-04-09,606,03015224,TRUCCAZZANO,MILANO,22,4,26
2020-04-09,607,03016060,CASNIGO,BERGAMO,27,17,44
2020-04-09,608,03012030,CANTELLO,VARESE,11,1,12
2020-04-09,609,03020065,SUZZARA,MANTOVA,50,7,57
2020-04-09,610,03018073,GODIASCO SALICE TERME,PAVIA,10,3,13
2020-04-09,611,03018045,CERGNAGO,PAVIA,3,0,3
2020-04-09,612,03018016,BORGO PRIOLO,PAVIA,4,3,7
2020-04-09,614,03018062,FERRERA ERBOGNONE,PAVIA,4,0,4
2020-04-09,615,03019067,PANDINO,CREMONA,72,22,94
2020-04-09,616,03014066,TIRANO,SONDRIO,41,4,45
2020-04-09,617,03018004,ALBUZZANO,PAVIA,36,13,49
2020-04-09,618,03108050,VIMERCATE,MONZA E DELLA BRIANZA,143,23,166
2020-04-09,619,03015247,ZIBIDO SAN GIACOMO,MILANO,9,0,9
2020-04-09,620,03018161,TORRICELLA VERZATE,PAVIA,3,0,3
2020-04-09,621,03020036,MONZAMBANO,MANTOVA,11,1,12
2020-04-09,622,03018114,PIEVE PORTO MORONE,PAVIA,27,4,31
2020-04-09,624,03019028,CELLA DATI,CREMONA,4,0,4
2020-04-09,625,03015166,PADERNO DUGNANO,MILANO,196,22,218
2020-04-09,626,03016066,CAVERNAGO,BERGAMO,6,5,11
2020-04-09,627,03012076,GERMIGNAGA,VARESE,5,0,5
2020-04-09,628,03019051,GRUMELLO CREMONESE ED UNITI,CREMONA,16,4,20
2020-04-09,629,03020027,GONZAGA,MANTOVA,27,2,29
2020-04-09,630,03016056,CARONA,BERGAMO,0,1,1
2020-04-09,631,03015015,BASIGLIO,MILANO,19,5,24
2020-04-09,632,03012038,CASCIAGO,VARESE,4,2,6
2020-04-09,633,03016117,GRASSOBBIO,BERGAMO,54,16,70
2020-04-09,634,03016247,COSTA SERINA,BERGAMO,9,3,12
2020-04-09,635,03019088,SAN BASSANO,CREMONA,22,5,27
2020-04-09,636,03016071,CERETE,BERGAMO,14,1,15
2020-04-09,637,03012087,LAVENO - MOMBELLO,VARESE,31,1,32
2020-04-09,638,03016015,AVIATICO,BERGAMO,5,1,6
2020-04-09,639,03013037,CAGLIO,COMO,3,0,3
2020-04-09,640,03016234,VERTOVA,BERGAMO,37,20,57
2020-04-09,641,03018026,CAMPOSPINOSO,PAVIA,9,4,13
2020-04-09,643,03016221,UBIALE CLANEZZO,BERGAMO,7,4,11
2020-04-09,644,03015195,SAN GIULIANO MILANESE,MILANO,138,33,171
2020-04-09,645,03012078,GORLA MAGGIORE,VARESE,8,0,8
2020-04-09,646,03013202,ROVELLO PORRO,COMO,11,1,12
2020-04-09,647,03013188,PONTE LAMBRO,COMO,6,2,8
2020-04-09,648,03019081,RIPALTA CREMASCA,CREMONA,39,7,46
2020-04-09,649,03015229,VANZAGO,MILANO,30,5,35
2020-04-09,650,03012042,CASTELLANZA,VARESE,36,3,39
2020-04-09,651,03015098,CUSANO MILANINO,MILANO,71,11,82
2020-04-09,652,03097040,INTROBIO,LECCO,8,2,10
2020-04-09,653,03016163,PIARIO,BERGAMO,14,3,17
2020-04-09,654,03017145,POLPENAZZE DEL GARDA,BRESCIA,14,3,17
2020-04-09,655,03098059,VALERA FRATTA,LODI,6,3,9
2020-04-09,656,03013004,ALBESE CON CASSANO,COMO,91,3,94
2020-04-09,657,03108049,VILLASANTA,MONZA E DELLA BRIANZA,48,4,52
2020-04-09,658,03097005,BARZAGO,LECCO,8,4,12
2020-04-09,659,03017134,PARATICO,BRESCIA,31,12,43
2020-04-09,660,03016059,CASIRATE D`ADDA,BERGAMO,20,8,28
2020-04-09,735,03017133,PALAZZOLO SULL`OGLIO,BRESCIA,118,47,165
2020-04-09,739,03014017,CERCINO,SONDRIO,3,0,3
2020-04-09,740,03017047,CEDEGOLO,BRESCIA,11,0,11
2020-04-09,741,03017070,ESINE,BRESCIA,59,6,65
2020-04-09,661,03015134,MARCALLO CON CASONE,MILANO,20,2,22
2020-04-09,662,03019099,SOSPIRO,CREMONA,43,7,50
2020-04-09,663,03015116,LAINATE,MILANO,74,9,83
2020-04-09,664,03015022,BESATE,MILANO,3,0,3
2020-04-09,665,03097002,AIRUNO,LECCO,11,3,14
2020-04-09,666,03098001,ABBADIA CERRETO,LODI,4,0,4
2020-04-09,667,03015050,CARPIANO,MILANO,8,0,8
2020-04-09,668,03017035,CAPO DI PONTE,BRESCIA,21,3,24
2020-04-09,670,03017040,CASTEGNATO,BRESCIA,48,20,68
2020-04-09,671,03020010,CASALMORO,MANTOVA,20,6,26
2020-04-09,672,03019068,PERSICO DOSIMO,CREMONA,49,4,53
2020-04-09,673,03017100,MALEGNO,BRESCIA,23,3,26
2020-04-09,674,03098033,MACCASTORNA,LODI,1,0,1
2020-04-09,675,03018068,GAMBOLO`,PAVIA,42,15,57
2020-04-09,676,03097079,TACENO,LECCO,1,0,1
2020-04-09,677,03108020,COGLIATE,MONZA E DELLA BRIANZA,19,0,19
2020-04-09,678,03019109,TRESCORE CREMASCO,CREMONA,21,6,27
2020-04-09,679,03012035,CARONNO VARESINO,VARESE,7,0,7
2020-04-09,680,03016240,VILLA DI SERIO,BERGAMO,55,27,82
2020-04-09,681,03019018,CASALETTO CEREDANO,CREMONA,9,1,10
2020-04-09,682,03017112,MONTICELLI BRUSATI,BRESCIA,35,7,42
2020-04-09,683,03013131,LOCATE VARESINO,COMO,2,1,3
2020-04-09,684,03098062,CASTELGERUNDO,LODI,34,1,35
2020-04-09,685,03018058,COSTA DE` NOBILI,PAVIA,5,0,5
2020-04-09,686,03020058,SAN GIOVANNI DEL DOSSO,MANTOVA,9,1,10
2020-04-09,687,03012072,GAVIRATE,VARESE,11,0,11
2020-04-09,688,03019087,SALVIROLA,CREMONA,10,0,10
2020-04-09,689,03015136,MASATE,MILANO,10,4,14
2020-04-09,691,03016108,GANDINO,BERGAMO,39,11,50
2020-04-09,692,03016116,GORNO,BERGAMO,22,6,28
2020-04-09,693,03017180,SOIANO DEL LAGO,BRESCIA,8,2,10
2020-04-09,694,03017167,RUDIANO,BRESCIA,22,4,26
2020-04-09,695,03015058,CASOREZZO,MILANO,19,3,22
2020-04-09,696,03019116,PIADENA DRIZZONA,CREMONA,24,4,28
2020-04-09,697,03014038,LOVERO,SONDRIO,1,0,1
2020-04-09,698,03018164,TROMELLO,PAVIA,8,4,12
2020-04-09,699,03012017,BREBBIA,VARESE,5,1,6
2020-04-09,700,03018097,MONTESCANO,PAVIA,5,1,6
2020-04-09,701,03015019,BERNATE TICINO,MILANO,3,1,4
2020-04-09,702,03012128,TRAVEDONA - MONATE,VARESE,7,0,7
2020-04-09,703,03017148,PONTE DI LEGNO,BRESCIA,10,1,11
2020-04-09,704,03016162,PIANICO,BERGAMO,12,2,14
2020-04-09,705,03017036,CAPOVALLE,BRESCIA,1,1,2
2020-04-09,706,03017187,TOSCOLANO MADERNO,BRESCIA,54,3,57
2020-04-09,707,03015181,RESCALDINA,MILANO,15,3,18
2020-04-09,708,03015184,ROBECCO SUL NAVIGLIO,MILANO,18,0,18
2020-04-09,709,03013254,CENTRO VALLE INTELVI,COMO,5,0,5
2020-04-09,710,03020014,CASTEL D`ARIO,MANTOVA,10,3,13
2020-04-09,711,03018041,CAVA MANARA,PAVIA,34,4,38
2020-04-09,712,03016102,FONTENO,BERGAMO,2,4,6
2020-04-09,713,03018057,CORVINO SAN QUIRICO,PAVIA,2,1,3
2020-04-09,714,03013048,CARUGO,COMO,11,2,13
2020-04-09,715,03016217,TORRE PALLAVICINA,BERGAMO,8,3,11
2020-04-09,716,03016235,VIADANICA,BERGAMO,2,3,5
2020-04-09,717,03016157,PALOSCO,BERGAMO,39,13,52
2020-04-09,718,03108039,SEREGNO,MONZA E DELLA BRIANZA,127,9,136
2020-04-09,719,03019061,MOTTA BALUFFI,CREMONA,10,1,11
2020-04-09,720,03014033,GROSIO,SONDRIO,12,2,14
2020-04-09,721,03013133,LOMAZZO,COMO,14,2,16
2020-04-09,722,03019077,POZZAGLIO ED UNITI,CREMONA,18,1,19
2020-04-09,723,03016050,CAPIZZONE,BERGAMO,7,6,13
2020-04-09,724,03017050,CETO,BRESCIA,21,2,23
2020-04-09,742,03012122,SOLBIATE OLONA,VARESE,9,0,9
2020-04-09,743,03013052,CASLINO D`ERBA,COMO,7,0,7
2020-04-09,744,03016203,SOTTO IL MONTE GIOVANNI XXIII,BERGAMO,30,10,40
2020-04-09,745,03016164,PIAZZA BREMBANA,BERGAMO,7,1,8
2020-04-09,746,03017097,MACLODIO,BRESCIA,8,1,9
2020-04-09,747,03013170,ORSENIGO,COMO,4,1,5
2020-04-09,748,03013046,CARIMATE,COMO,6,0,6
2020-04-09,814,03016176,PRESEZZO,BERGAMO,30,13,43
2020-04-09,816,03013012,AROSIO,COMO,12,4,16
2020-04-09,750,03015171,PESCHIERA BORROMEO,MILANO,55,22,77
2020-04-09,751,03020034,MEDOLE,MANTOVA,10,3,13
2020-04-09,752,03097035,ESINO LARIO,LECCO,4,0,4
2020-04-09,753,03017177,SENIGA,BRESCIA,7,0,7
2020-04-09,754,03098058,TURANO LODIGIANO,LODI,18,5,23
2020-04-09,755,03097017,CASSAGO BRIANZA,LECCO,19,2,21
2020-04-09,756,03016129,LURANO,BERGAMO,21,3,24
2020-04-09,757,03015125,LOCATE DI TRIULZI,MILANO,27,11,38
2020-04-09,758,03019041,DOVERA,CREMONA,20,5,25
2020-04-09,759,03108024,GIUSSANO,MONZA E DELLA BRIANZA,52,13,65
2020-04-09,760,03014071,VALDIDENTRO,SONDRIO,20,3,23
2020-04-09,761,03098060,VILLANOVA DEL SILLARO,LODI,11,1,12
2020-04-09,762,03016103,FOPPOLO,BERGAMO,1,0,1
2020-04-09,763,03017037,CAPRIANO DEL COLLE,BRESCIA,28,5,33
2020-04-09,764,03017043,CASTENEDOLO,BRESCIA,73,11,84
2020-04-09,765,03017039,CARPENEDOLO,BRESCIA,116,21,137
2020-04-09,766,03018154,SUARDI,PAVIA,1,1,2
2020-04-09,767,03019064,OSTIANO,CREMONA,29,5,34
2020-04-09,769,03014018,CHIAVENNA,SONDRIO,11,5,16
2020-04-09,770,03015150,MORIMONDO,MILANO,2,0,2
2020-04-09,771,03018169,VALLE SALIMBENE,PAVIA,9,0,9
2020-04-09,772,03016026,BIANZANO,BERGAMO,3,3,6
2020-04-09,768,03108034,MUGGIO`,MONZA E DELLA BRIANZA,61,22,83
2020-04-09,773,03017108,MILZANO,BRESCIA,9,2,11
2020-04-09,774,03097060,OLIVETO LARIO,LECCO,3,0,3
2020-04-09,775,03108016,CARNATE,MONZA E DELLA BRIANZA,30,5,35
2020-04-09,776,03097048,MERATE,LECCO,82,16,98
2020-04-09,777,03016001,ADRARA SAN MARTINO,BERGAMO,6,2,8
2020-04-09,778,03020028,GUIDIZZOLO,MANTOVA,57,20,77
2020-04-09,779,03013042,CANZO,COMO,15,5,20
2020-04-09,780,03012058,CUASSO AL MONTE,VARESE,4,1,5
2020-04-09,781,03016153,OSIO SOTTO,BERGAMO,86,30,116
2020-04-09,782,03016018,BAGNATICA,BERGAMO,26,15,41
2020-04-09,783,03019048,GERRE DE`CAPRIOLI,CREMONA,20,2,22
2020-04-09,784,03018065,FRASCAROLO,PAVIA,1,4,5
2020-04-09,785,03017023,BOTTICINO,BRESCIA,70,18,88
2020-04-09,786,03020059,SAN MARTINO DALL`ARGINE,MANTOVA,18,0,18
2020-04-09,787,03012059,CUGLIATE - FABIASCO,VARESE,3,0,3
2020-04-09,788,03012084,ISPRA,VARESE,1,1,2
2020-04-09,789,03098022,CORNO GIOVINE,LODI,14,8,22
2020-04-09,790,03097001,ABBADIA LARIANA,LECCO,12,2,14
2020-04-09,791,03017166,ROVATO,BRESCIA,116,32,148
2020-04-09,792,03015038,BUSCATE,MILANO,11,1,12
2020-04-09,793,03097044,LOMAGNA,LECCO,14,3,17
2020-04-09,794,03097076,SIRTORI,LECCO,5,0,5
2020-04-09,795,03012046,CASTIGLIONE OLONA,VARESE,7,0,7
2020-04-09,796,03018098,MONTESEGALE,PAVIA,1,0,1
2020-04-09,797,03016107,GANDELLINO,BERGAMO,4,4,8
2020-04-09,798,03012086,LAVENA PONTE TRESA,VARESE,8,1,9
2020-04-09,799,03015070,CERNUSCO SUL NAVIGLIO,MILANO,142,22,164
2020-04-09,800,03013053,CASNATE CON BERNATE,COMO,14,5,19
2020-04-09,801,03012082,INARZO,VARESE,4,0,4
2020-04-09,802,03016249,CORNALBA,BERGAMO,1,0,1
2020-04-09,803,03015179,PREGNANA MILANESE,MILANO,22,3,25
2020-04-09,804,03013246,ZELBIO,COMO,1,0,1
2020-04-09,805,03097082,VALGREGHENTINO,LECCO,8,1,9
2020-04-09,806,03097062,PADERNO D`ADDA,LECCO,16,4,20
2020-04-09,807,03013047,CARLAZZO,COMO,5,2,7
2020-04-09,808,03018037,CASTEGGIO,PAVIA,27,15,42
2020-04-09,809,03013165,OLGIATE COMASCO,COMO,15,1,16
2020-04-09,811,03016212,TELGATE,BERGAMO,31,11,42
2020-04-09,812,03017140,PERTICA BASSA,BRESCIA,9,0,9
2020-04-09,813,03097022,CIVATE,LECCO,18,5,23
2020-04-09,815,03013026,BLEVIO,COMO,5,0,5
2020-04-09,891,03016238,VILLA D`ADDA,BERGAMO,26,13,39
2020-04-09,893,03019056,MALAGNINO,CREMONA,19,3,22
2020-04-09,894,03018006,BADIA PAVESE,PAVIA,1,1,2
2020-04-09,817,03017014,BEDIZZOLE,BRESCIA,55,7,62
2020-04-09,818,03019001,ACQUANEGRA CREMONESE,CREMONA,15,9,24
2020-04-09,819,03015183,ROBECCHETTO CON INDUNO,MILANO,8,5,13
2020-04-09,820,03014003,ANDALO VALTELLINO,SONDRIO,1,0,1
2020-04-09,821,03013113,GRIANTE,COMO,1,0,1
2020-04-09,822,03019034,CREDERA RUBBIANO,CREMONA,15,1,16
2020-04-09,824,03016042,BRUSAPORTO,BERGAMO,31,12,43
2020-04-09,825,03016180,RIVA DI SOLTO,BERGAMO,3,6,9
2020-04-09,826,03017139,PERTICA ALTA,BRESCIA,1,0,1
2020-04-09,827,03020071,BORGO VIRGILIO,MANTOVA,69,4,73
2020-04-09,828,03020018,CAVRIANA,MANTOVA,23,6,29
2020-04-09,829,03017124,ONO SAN PIETRO,BRESCIA,9,2,11
2020-04-09,831,03018061,DORNO,PAVIA,22,4,26
2020-04-09,832,03018022,BREME,PAVIA,2,1,3
2020-04-09,830,03013192,PROSERPIO,COMO,4,0,4
2020-04-09,833,03097037,GARBAGNATE MONASTERO,LECCO,4,2,6
2020-04-09,834,03017142,PIAN CAMUNO,BRESCIA,25,3,28
2020-04-09,835,03017113,MONTICHIARI,BRESCIA,192,23,215
2020-04-09,836,03016055,CAROBBIO DEGLI ANGELI,BERGAMO,21,5,26
2020-04-09,837,03015122,LISCATE,MILANO,14,4,18
2020-04-09,838,03017202,VIONE,BRESCIA,9,2,11
2020-04-09,839,03018113,PIEVE DEL CAIRO,PAVIA,6,4,10
2020-04-09,840,03020035,MOGLIA,MANTOVA,21,5,26
2020-04-09,841,03017147,PONCARALE,BRESCIA,27,9,36
2020-04-09,842,03012062,CUVEGLIO,VARESE,5,1,6
2020-04-09,843,03018176,VIDIGULFO,PAVIA,31,1,32
2020-04-09,844,03018112,PIEVE ALBIGNOLA,PAVIA,1,0,1
2020-04-09,845,03018035,CASSOLNOVO,PAVIA,30,9,39
2020-04-09,846,03097011,BULCIAGO,LECCO,10,1,11
2020-04-09,847,03020025,GAZZUOLO,MANTOVA,6,2,8
2020-04-09,848,03016222,URGNANO,BERGAMO,51,23,74
2020-04-09,849,03097067,PERLEDO,LECCO,21,3,24
2020-04-09,850,03015151,MOTTA VISCONTI,MILANO,7,0,7
2020-04-09,851,03018067,GAMBARANA,PAVIA,1,0,1
2020-04-09,852,03017125,ORZINUOVI,BRESCIA,136,55,191
2020-04-09,853,03018182,VOGHERA,PAVIA,192,92,284
2020-04-09,854,03016190,SAN PELLEGRINO TERME,BERGAMO,42,17,59
2020-04-09,855,03018099,MONTICELLI PAVESE,PAVIA,1,0,1
2020-04-09,856,03012075,GERENZANO,VARESE,15,2,17
2020-04-09,857,03016186,ROTA D`IMAGNA,BERGAMO,4,3,7
2020-04-09,858,03013229,VALBRONA,COMO,9,1,10
2020-04-09,859,03016148,ONETA,BERGAMO,6,1,7
2020-04-09,860,03013003,ALBAVILLA,COMO,16,4,20
2020-04-09,861,03012065,DUMENZA,VARESE,3,0,3
2020-04-09,862,03018179,VILLANOVA D`ARDENGHI,PAVIA,4,1,5
2020-04-09,863,03108002,AICURZIO,MONZA E DELLA BRIANZA,5,2,7
2020-04-09,864,03108001,AGRATE BRIANZA,MONZA E DELLA BRIANZA,50,13,63
2020-04-09,865,03016020,BARIANO,BERGAMO,25,6,31
2020-04-09,866,03016236,VIGANO SAN MARTINO,BERGAMO,9,1,10
2020-04-09,867,03012124,SUMIRAGO,VARESE,6,0,6
2020-04-09,868,03016198,SERIATE,BERGAMO,183,61,244
2020-04-09,869,03097078,SUELLO,LECCO,24,5,29
2020-04-09,870,03018137,SAN MARTINO SICCOMARIO,PAVIA,24,0,24
2020-04-09,871,03013147,MERONE,COMO,17,1,18
2020-04-09,872,03016067,CAZZANO SANT`ANDREA,BERGAMO,15,2,17
2020-04-09,873,03018094,MONTALTO PAVESE,PAVIA,0,2,2
2020-04-09,874,03019016,CASALBUTTANO ED UNITI,CREMONA,52,10,62
2020-04-09,875,03016140,MORENGO,BERGAMO,14,4,18
2020-04-09,876,03098028,GRAFFIGNANA,LODI,12,1,13
2020-04-09,877,03013024,BIZZARONE,COMO,3,0,3
2020-04-09,878,03108018,CERIANO LAGHETTO,MONZA E DELLA BRIANZA,10,0,10
2020-04-09,879,03015077,CINISELLO BALSAMO,MILANO,255,41,296
2020-04-09,880,03097003,ANNONE DI BRIANZA,LECCO,12,1,13
2020-04-09,883,03020046,QUINGENTOLE,MANTOVA,2,0,2
2020-04-09,884,03016035,BRACCA,BERGAMO,7,1,8
2020-04-09,885,03019043,FIESCO,CREMONA,17,0,17
2020-04-09,886,03017062,CORTE FRANCA,BRESCIA,38,13,51
2020-04-09,887,03016063,CASTEL ROZZONE,BERGAMO,23,4,27
2020-04-09,888,03017163,RODENGO - SAIANO,BRESCIA,50,20,70
2020-04-09,889,03108007,BERNAREGGIO,MONZA E DELLA BRIANZA,41,10,51
2020-04-09,890,03015086,CORMANO,MILANO,77,22,99
2020-04-09,896,03015168,PARABIAGO,MILANO,57,7,64
2020-04-09,897,03020031,MARCARIA,MANTOVA,33,5,38
2020-04-09,926,03016142,MOZZANICA,BERGAMO,15,4,19
2020-04-09,927,03016224,VALBREMBO,BERGAMO,36,11,47
2020-04-09,898,03017021,BORGOSATOLLO,BRESCIA,100,17,117
2020-04-09,899,03012092,LUINO,VARESE,11,1,12
2020-04-09,900,03015130,MAGENTA,MILANO,101,5,106
2020-04-09,902,03019073,PIERANICA,CREMONA,5,4,9
2020-04-09,903,03016152,OSIO SOPRA,BERGAMO,31,12,43
2020-04-09,906,03019075,PIEVE SAN GIACOMO,CREMONA,12,3,15
2020-04-09,907,03014073,VALFURVA,SONDRIO,17,2,19
2020-04-09,908,03015189,ROZZANO,MILANO,98,23,121
2020-04-09,909,03013245,VILLA GUARDIA,COMO,12,3,15
2020-04-09,910,03016158,PARRE,BERGAMO,25,7,32
2020-04-09,911,03016132,MAPELLO,BERGAMO,45,13,58
2020-04-09,912,03017005,ANFO,BRESCIA,2,0,2
2020-04-09,913,03097068,PESCATE,LECCO,8,2,10
2020-04-09,914,03016076,CIVIDATE AL PIANO,BERGAMO,36,19,55
2020-04-09,915,03016016,AZZANO SAN PAOLO,BERGAMO,41,21,62
2020-04-09,917,03019005,BAGNOLO CREMASCO,CREMONA,38,8,46
2020-04-09,918,03098004,BORGHETTO LODIGIANO,LODI,64,18,82
2020-04-09,919,03019103,STAGNO LOMBARDO,CREMONA,11,7,18
2020-04-09,920,03018014,BEREGUARDO,PAVIA,11,0,11
2020-04-09,922,03097046,MANDELLO DEL LARIO,LECCO,23,7,30
2020-04-09,923,03015173,PIEVE EMANUELE,MILANO,47,8,55
2020-04-09,924,03018145,SAN ZENONE AL PO,PAVIA,1,0,1
2020-04-09,925,03017114,MONTIRONE,BRESCIA,47,15,62
2020-04-09,941,03018121,RETORBIDO,PAVIA,8,3,11
2020-04-09,942,03016115,GORLE,BERGAMO,41,14,55
2020-04-09,943,03097045,MALGRATE,LECCO,20,4,24
2020-04-09,944,03016118,GROMO,BERGAMO,18,4,22
2020-04-09,945,03016127,LOCATELLO,BERGAMO,7,2,9
2020-04-09,947,03019095,SESTO ED UNITI,CREMONA,20,3,23
2020-04-09,948,03016048,CAMERATA CORNELLO,BERGAMO,4,2,6
2020-04-09,949,03020052,RONCOFERRARO,MANTOVA,7,0,7
2020-04-09,950,03014032,GORDONA,SONDRIO,9,1,10
2020-04-09,951,03013206,SAN FERMO DELLA BATTAGLIA,COMO,13,3,16
2020-04-09,952,03016245,ZANICA,BERGAMO,39,25,64
2020-04-09,953,03016128,LOVERE,BERGAMO,44,7,51
2020-04-09,954,03015242,VIMODRONE,MILANO,61,17,78
2020-04-09,955,03016033,BOSSICO,BERGAMO,4,1,5
2020-04-09,956,03017020,BORGO SAN GIACOMO,BRESCIA,68,17,85
2020-04-09,957,03097020,CERNUSCO LOMBARDONE,LECCO,29,3,32
2020-04-09,958,03097008,BELLANO,LECCO,25,6,31
2020-04-09,959,03014023,COLORINA,SONDRIO,3,0,3
2020-04-09,960,03015226,TURBIGO,MILANO,15,1,16
2020-04-09,961,03019083,RIVAROLO DEL RE ED UNITI,CREMONA,13,3,16
2020-04-09,963,03098023,CORNOVECCHIO,LODI,3,0,3
2020-04-09,964,03018191,CORNALE E BASTIDA,PAVIA,2,5,7
2020-04-09,965,03019052,GUSSOLA,CREMONA,15,2,17
2020-04-09,966,03013036,CADORAGO,COMO,13,2,15
2020-04-09,967,03014029,FORCOLA,SONDRIO,3,0,3
2020-04-09,968,03016161,PEIA,BERGAMO,8,7,15
2020-04-09,970,03017159,QUINZANO D`OGLIO,BRESCIA,41,18,59
2020-04-09,971,03015055,CASARILE,MILANO,15,4,19
2020-04-09,972,03015012,BAREGGIO,MILANO,50,11,61
2020-04-09,974,03013045,CARBONATE,COMO,1,0,1
2020-04-09,975,03019114,VOLONGO,CREMONA,5,0,5
2020-04-09,977,03016114,GORLAGO,BERGAMO,34,11,45
2020-04-09,978,03017204,VOBARNO,BRESCIA,56,8,64
2020-04-09,979,03017016,BERZO DEMO,BRESCIA,14,2,16
2020-04-09,981,03013145,MENAGGIO,COMO,9,2,11
2020-04-09,983,03017024,BOVEGNO,BRESCIA,5,1,6
2020-04-09,984,03012048,CAVARIA CON PREMEZZO,VARESE,8,0,8
2020-04-09,980,03017102,MANERBA DEL GARDA,BRESCIA,20,5,25
2020-04-09,982,03017045,CASTREZZATO,BRESCIA,39,8,47
2020-04-09,985,03016178,RANICA,BERGAMO,39,14,53
2020-04-09,986,03017157,PROVAGLIO VAL SABBIA,BRESCIA,4,1,5
2020-04-09,988,03097016,CASATENOVO,LECCO,58,14,72
2020-04-09,989,03013121,LAMBRUGO,COMO,9,3,12
2020-04-09,990,03016028,BOLGARE,BERGAMO,41,13,54
2020-04-09,991,03016082,CORNA IMAGNA,BERGAMO,11,0,11
2020-04-09,992,03018131,ROVESCALA,PAVIA,3,0,3
2020-04-09,993,03017118,NIARDO,BRESCIA,15,1,16
2020-04-09,994,03018122,RIVANAZZANO TERME,PAVIA,24,9,33
2020-04-09,995,03013111,GRANDOLA ED UNITI,COMO,3,1,4
2020-04-09,996,03014040,MAZZO DI VALTELLINA,SONDRIO,2,0,2
2020-04-09,997,03017076,GARGNANO,BRESCIA,10,0,10
2020-04-09,998,03019030,CICOGNOLO,CREMONA,14,0,14
2020-04-09,999,03015026,BOFFALORA SOPRA TICINO,MILANO,7,2,9
2020-04-09,1000,03013138,LURATE CACCIVIO,COMO,8,1,9
2020-04-09,1001,03016121,ISOLA DI FONDRA,BERGAMO,0,1,1
2020-04-09,1002,03016005,ALME`,BERGAMO,37,17,54
2020-04-09,1003,03018089,MENCONICO,PAVIA,2,1,3
2020-04-09,928,03017127,OSPITALETTO,BRESCIA,95,30,125
2020-04-09,929,03019107,TORRE DE` PICENARDI,CREMONA,6,2,8
2020-04-09,931,03015178,POZZUOLO MARTESANA,MILANO,31,8,39
2020-04-09,932,03020064,SUSTINENTE,MANTOVA,3,2,5
2020-04-09,933,03017198,VEZZA D`OGLIO,BRESCIA,10,2,12
2020-04-09,934,03097058,OLGIATE MOLGORA,LECCO,28,5,33
2020-04-09,935,03016013,ARZAGO D`ADDA,BERGAMO,9,1,10
2020-04-09,936,03097047,MARGNO,LECCO,1,0,1
2020-04-09,937,03017071,FIESSE,BRESCIA,13,1,14
2020-04-09,938,03016252,SANT`OMOBONO TERME,BERGAMO,14,7,21
2020-04-09,939,03016125,LENNA,BERGAMO,5,4,9
2020-04-09,940,03098015,CASTIRAGA VIDARDO,LODI,9,0,9
2020-04-09,1122,03019049,GOMBITO,CREMONA,6,1,7
2020-04-09,1123,03018008,BARBIANELLO,PAVIA,2,3,5
2020-04-09,1125,03015220,TREZZANO SUL NAVIGLIO,MILANO,41,7,48
2020-04-09,1126,03012024,BRUSIMPIANO,VARESE,1,0,1
2020-04-09,1127,03018069,GARLASCO,PAVIA,35,20,55
2020-04-09,1128,03016062,CASTELLI CALEPIO,BERGAMO,57,36,93
2020-04-09,1130,03016120,GRUMELLO DEL MONTE,BERGAMO,57,18,75
2020-04-09,1131,03013095,ERBA,COMO,86,10,96
2020-04-09,1132,03016202,SORISOLE,BERGAMO,46,15,61
2020-04-09,1133,03016004,ALBINO,BERGAMO,151,66,217
2020-04-09,1134,03017055,CIVIDATE CAMUNO,BRESCIA,24,4,28
2020-04-09,1135,03018124,ROBECCO PAVESE,PAVIA,3,1,4
2020-04-09,1136,03015249,VANZAGHELLO,MILANO,9,1,10
2020-04-09,1137,03016079,COLOGNO AL SERIO,BERGAMO,52,15,67
2020-04-09,1244,03015044,CAMBIAGO,MILANO,17,1,18
2020-04-09,1245,03016220,TREVIOLO,BERGAMO,87,26,113
2020-04-09,1349,03018165,TROVO,PAVIA,2,0,2
2020-04-09,1351,03012011,BESANO,VARESE,3,0,3
2020-04-09,1352,03016233,VERDELLO,BERGAMO,52,14,66
2020-04-09,1353,03017068,EDOLO,BRESCIA,35,4,39
2020-04-09,1354,03017010,BAGOLINO,BRESCIA,10,5,15
2020-04-09,1355,03013126,LEZZENO,COMO,4,1,5
2020-04-09,1392,03013186,POGNANA LARIO,COMO,3,0,3
2020-04-09,1393,03108036,ORNAGO,MONZA E DELLA BRIANZA,19,1,20
2020-04-09,1394,03015222,TRIBIANO,MILANO,16,2,18
2020-04-09,1395,03012063,CUVIO,VARESE,1,0,1
2020-04-09,1396,03019031,CINGIA DE` BOTTI,CREMONA,8,0,8
2020-04-09,1397,03015002,ABBIATEGRASSO,MILANO,99,23,122
2020-04-09,1398,03013035,CABIATE,COMO,12,1,13
2020-04-09,1399,03019003,ANNICCO,CREMONA,22,8,30
2020-04-09,1400,03015112,GUDO VISCONTI,MILANO,1,1,2
2020-04-09,1401,03016077,CLUSONE,BERGAMO,86,29,115
2020-04-09,1403,03097050,MOGGIO,LECCO,1,0,1
2020-04-09,1405,03013089,DOMASO,COMO,3,1,4
2020-04-09,1406,03097021,CESANA BRIANZA,LECCO,17,7,24
2020-04-09,1246,03015007,ARCONATE,MILANO,9,2,11
2020-04-09,1247,03012032,CARDANO AL CAMPO,VARESE,20,3,23
2020-04-09,1248,03097069,PREMANA,LECCO,20,2,22
2020-04-09,1250,03016143,MOZZO,BERGAMO,52,17,69
2020-04-09,1251,03018054,CORANA,PAVIA,1,0,1
2020-04-09,1253,03018050,CILAVEGNA,PAVIA,15,3,18
2020-04-09,1254,03013255,SOLBIATE CON CAGNO,COMO,3,1,4
2020-04-09,1255,03016168,PONTE NOSSA,BERGAMO,18,5,23
2020-04-09,1256,03014078,VILLA DI TIRANO,SONDRIO,6,7,13
2020-04-09,1257,03016100,FIORANO AL SERIO,BERGAMO,24,13,37
2020-04-09,1356,03108038,RONCO BRIANTINO,MONZA E DELLA BRIANZA,16,5,21
2020-04-09,1357,03016126,LEVATE,BERGAMO,18,10,28
2020-04-09,1358,03020063,SOLFERINO,MANTOVA,5,2,7
2020-04-09,1360,03017205,ZONE,BRESCIA,6,1,7
2020-04-09,1362,03018076,GROPELLO CAIROLI,PAVIA,22,8,30
2020-04-09,1363,03017061,CONCESIO,BRESCIA,113,20,133
2020-04-09,1402,03019057,MARTIGNANA DI PO,CREMONA,15,1,16
2020-04-09,1404,03019020,CASALETTO VAPRIO,CREMONA,26,4,30
2020-04-09,1408,03019060,MOSCAZZANO,CREMONA,5,1,6
2020-04-09,1409,03097084,VARENNA,LECCO,1,0,1
2020-04-09,1410,03012047,CASTRONNO,VARESE,6,0,6
2020-04-09,1411,03017122,OFFLAGA,BRESCIA,27,6,33
2020-04-09,1412,03018105,OLIVA GESSI,PAVIA,0,1,1
2020-04-09,1413,03017160,REMEDELLO,BRESCIA,23,6,29
2020-04-09,1258,03013135,LUISAGO,COMO,2,0,2
2020-04-09,1259,03017025,BOVEZZO,BRESCIA,43,11,54
2020-04-09,1359,03013097,EUPILIO,COMO,10,2,12
2020-04-09,1364,03014011,CAIOLO,SONDRIO,1,1,2
2020-04-09,1365,03098029,GUARDAMIGLIO,LODI,20,6,26
2020-04-09,1366,03013227,TURATE,COMO,26,1,27
2020-04-09,1367,03012106,MORNAGO,VARESE,5,1,6
2020-04-09,1368,03016218,TRESCORE BALNEARIO,BERGAMO,65,13,78
2020-04-09,1369,03015243,VITTUONE,MILANO,52,2,54
2020-04-09,1370,03108008,BESANA IN BRIANZA,MONZA E DELLA BRIANZA,30,12,42
2020-04-09,1371,03097004,BALLABIO,LECCO,22,6,28
2020-04-09,1372,03017182,SULZANO,BRESCIA,10,5,15
2020-04-09,1373,03097038,GARLATE,LECCO,13,1,14
2020-04-09,1375,03098048,SAN MARTINO IN STRADA,LODI,35,10,45
2020-04-09,1377,03013159,MOZZATE,COMO,15,1,16
2020-04-09,1414,03108012,BRUGHERIO,MONZA E DELLA BRIANZA,131,28,159
2020-04-09,1416,03016185,RONCOLA,BERGAMO,4,2,6
2020-04-09,1417,03017130,PADERNO FRANCIACORTA,BRESCIA,20,6,26
2020-04-09,1418,03019062,OFFANENGO,CREMONA,69,19,88
2020-04-09,1260,03019029,CHIEVE,CREMONA,13,2,15
2020-04-09,1261,03015191,SAN COLOMBANO AL LAMBRO,MILANO,52,29,81
2020-04-09,1262,03013169,OLTRONA DI SAN MAMETTE,COMO,1,1,2
2020-04-09,1263,03108015,CARATE BRIANZA,MONZA E DELLA BRIANZA,59,8,67
2020-04-09,1264,03108021,CONCOREZZO,MONZA E DELLA BRIANZA,66,12,78
2020-04-09,1265,03019102,SPINO D`ADDA,CREMONA,23,2,25
2020-04-09,1266,03020072,BORGO MANTOVANO,MANTOVA,31,2,33
2020-04-09,1378,03017146,POMPIANO,BRESCIA,29,4,33
2020-04-09,1379,03016032,BORGO DI TERZO,BERGAMO,7,3,10
2020-04-09,1380,03018163,TRIVOLZIO,PAVIA,4,2,6
2020-04-09,1381,03013134,LONGONE AL SEGRINO,COMO,6,0,6
2020-04-09,1382,03017049,CERVENO,BRESCIA,5,3,8
2020-04-09,1419,03018015,BORGARELLO,PAVIA,10,0,10
2020-04-09,1420,03012079,GORLA MINORE,VARESE,19,2,21
2020-04-09,1421,03014020,CHIURO,SONDRIO,7,2,9
2020-04-09,1422,03013130,LIVO,COMO,1,0,1
2020-04-09,1423,03017082,IDRO,BRESCIA,9,2,11
2020-04-09,1424,03018171,VARZI,PAVIA,21,6,27
2020-04-09,1425,03017067,DESENZANO DEL GARDA,BRESCIA,141,25,166
2020-04-09,1267,03015097,CUSAGO,MILANO,10,1,11
2020-04-09,1269,03097065,PASTURO,LECCO,5,1,6
2020-04-09,1270,03014065,TEGLIO,SONDRIO,17,5,22
2020-04-09,1271,03018115,PINAROLO PO,PAVIA,4,2,6
2020-04-09,1272,03019063,OLMENETA,CREMONA,13,2,15
2020-04-09,1273,03012067,FAGNANO OLONA,VARESE,18,1,19
2020-04-09,1383,03013068,CIRIMIDO,COMO,5,0,5
2020-04-09,1384,03018023,BRESSANA BOTTARONE,PAVIA,16,4,20
2020-04-09,1385,03098041,MULAZZANO,LODI,32,4,36
2020-04-09,1386,03016197,SELVINO,BERGAMO,7,9,16
2020-04-09,1387,03013207,SAN NAZZARO VAL CAVARGNA,COMO,3,0,3
2020-04-09,1388,03098042,ORIO LITTA,LODI,10,2,12
2020-04-09,1389,03019007,BORDOLANO,CREMONA,15,0,15
2020-04-09,1390,03018180,VILLANTERIO,PAVIA,16,6,22
2020-04-09,1391,03016150,ORIO AL SERIO,BERGAMO,12,3,15
2020-04-09,1426,03017128,OSSIMO,BRESCIA,10,0,10
2020-04-09,1427,03015205,SEGRATE,MILANO,129,22,151
2020-04-09,1428,03014022,CIVO,SONDRIO,4,0,4
2020-04-09,1429,03098034,MAIRAGO,LODI,3,1,4
2020-04-09,1430,03098044,OSSAGO LODIGIANO,LODI,7,3,10
2020-04-09,1431,03019080,RIPALTA ARPINA,CREMONA,12,3,15
2020-04-09,1432,03017174,SAREZZO,BRESCIA,53,16,69
2020-04-09,1433,03017144,POLAVENO,BRESCIA,7,1,8
2020-04-09,1435,03019012,CAPERGNANICA,CREMONA,19,4,23
2020-04-09,1436,03108031,MEZZAGO,MONZA E DELLA BRIANZA,20,6,26
2020-04-09,1437,03097012,CALCO,LECCO,30,6,36
2020-04-09,1438,03016091,DALMINE,BERGAMO,182,49,231
2020-04-09,1274,03016243,VILMINORE DI SCALVE,BERGAMO,9,1,10
2020-04-09,1275,03098036,MARUDO,LODI,6,0,6
2020-04-09,1276,03015060,CASSINA DE PECCHI,MILANO,47,4,51
2020-04-09,1277,03012126,TERNATE,VARESE,4,0,4
2020-04-09,1278,03013204,SAN BARTOLOMEO VAL CAVARGNA,COMO,0,1,1
2020-04-09,1279,03013189,PORLEZZA,COMO,9,1,10
2020-04-09,1280,03012096,MALNATE,VARESE,52,7,59
2020-04-09,1281,03019026,CASTELVERDE,CREMONA,89,9,98
2020-04-09,1282,03013157,MONTORFANO,COMO,4,1,5
2020-04-09,1283,03108037,RENATE,MONZA E DELLA BRIANZA,14,4,18
2020-04-09,1004,03019004,AZZANELLO,CREMONA,10,2,12
2020-04-09,1005,03108022,CORREZZANA,MONZA E DELLA BRIANZA,6,0,6
2020-04-09,1006,03016064,CASTIONE DELLA PRESOLANA,BERGAMO,47,7,54
2020-04-09,1007,03097053,MONTEVECCHIA,LECCO,8,2,10
2020-04-09,1008,03017185,TIGNALE,BRESCIA,3,0,3
2020-04-09,1009,03017193,VALLIO TERME,BRESCIA,12,0,12
2020-04-09,1012,03108030,MEDA,MONZA E DELLA BRIANZA,42,6,48
2020-04-09,1013,03097072,ROGENO,LECCO,12,5,17
2020-04-09,1014,03016171,PONTIDA,BERGAMO,17,6,23
2020-04-09,1015,03016070,CENE,BERGAMO,26,13,39
2020-04-09,1016,03098043,OSPEDALETTO LODIGIANO,LODI,15,3,18
2020-04-09,1017,03017172,SAN GERVASIO BRESCIANO,BRESCIA,8,4,12
2020-04-09,1018,03016092,DOSSENA,BERGAMO,8,2,10
2020-04-09,1019,03018049,CIGOGNOLA,PAVIA,7,2,9
2020-04-09,1020,03019046,GADESCO PIEVE DELMONA,CREMONA,19,2,21
2020-04-09,1021,03098051,SANTO STEFANO LODIGIANO,LODI,19,7,26
2020-04-09,1022,03016205,SPINONE AL LAGO,BERGAMO,8,1,9
2020-04-09,1023,03097070,PRIMALUNA,LECCO,3,1,4
2020-04-09,1024,03108043,TRIUGGIO,MONZA E DELLA BRIANZA,21,1,22
2020-04-09,1025,03097043,LIERNA,LECCO,3,0,3
2020-04-09,1026,03012045,CASTELVECCANA,VARESE,1,1,2
2020-04-09,1027,03018095,MONTEBELLO DELLA BATTAGLIA,PAVIA,5,4,9
2020-04-09,1029,03013099,FALOPPIO,COMO,2,0,2
2020-04-09,1030,03014014,CASTELLO DELL`ACQUA,SONDRIO,1,1,2
2020-04-09,1439,03018129,RONCARO,PAVIA,8,1,9
2020-04-09,1440,03097025,CORTENOVA,LECCO,1,1,2
2020-04-09,1441,03017181,SONICO,BRESCIA,10,2,12
2020-04-09,1442,03015096,CUGGIONO,MILANO,12,5,17
2020-04-09,1443,03014016,CEDRASCO,SONDRIO,1,2,3
2020-04-09,1444,03020050,RIVAROLO MANTOVANO,MANTOVA,30,9,39
2020-04-09,1445,03012102,MESENZANA,VARESE,2,0,2
2020-04-09,1446,03018104,OLEVANO DI LOMELLINA,PAVIA,2,0,2
2020-04-09,1447,03108045,VAREDO,MONZA E DELLA BRIANZA,36,11,47
2020-04-09,1448,03014005,ARDENNO,SONDRIO,11,0,11
2020-04-09,1449,03020066,VIADANA,MANTOVA,92,32,124
2020-04-09,1450,03018146,SARTIRANA LOMELLINA,PAVIA,4,3,7
2020-04-09,1451,03014057,SAMOLACO,SONDRIO,5,0,5
2020-04-09,1452,03016069,CENATE SOTTO,BERGAMO,17,1,18
2020-04-09,1453,03017028,BRENO,BRESCIA,44,7,51
2020-04-09,1284,03019058,MONTE CREMASCO,CREMONA,9,4,13
2020-04-09,1285,03016109,GANDOSSO,BERGAMO,14,4,18
2020-04-09,1286,03018012,BATTUDA,PAVIA,1,1,2
2020-04-09,1287,03018168,VALLE LOMELLINA,PAVIA,7,2,9
2020-04-09,1288,03018079,LANGOSCO,PAVIA,2,0,2
2020-04-09,1289,03017078,GHEDI,BRESCIA,113,24,137
2020-04-09,1290,03015158,NOVIGLIO,MILANO,8,1,9
2020-04-09,1291,03018120,REDAVALLE,PAVIA,4,2,6
2020-04-09,1293,03013252,TREMEZZINA,COMO,26,9,35
2020-04-09,1294,03016003,ALBANO SANT`ALESSANDRO,BERGAMO,43,14,57
2020-04-09,1295,03016195,SCHILPARIO,BERGAMO,6,3,9
2020-04-09,1031,03012109,ORIGGIO,VARESE,22,2,24
2020-04-09,1032,03016210,TALEGGIO,BERGAMO,6,2,8
2020-04-09,1033,03017046,CAZZAGO SAN MARTINO,BRESCIA,75,27,102
2020-04-09,1034,03016156,PALAZZAGO,BERGAMO,22,3,25
2020-04-09,1035,03019112,VAILATE,CREMONA,32,16,48
2020-04-09,1036,03013102,FINO MORNASCO,COMO,26,6,32
2020-04-09,1037,03014034,GROSOTTO,SONDRIO,3,1,4
2020-04-09,1038,03015106,GESSATE,MILANO,35,8,43
2020-04-09,1039,03013055,CASSINA RIZZARDI,COMO,8,2,10
2020-04-09,1040,03098056,TAVAZZANO CON VILLAVESCO,LODI,35,6,41
2020-04-09,1041,03015062,CASTANO PRIMO,MILANO,25,6,31
2020-04-09,1042,03012118,SAMARATE,VARESE,12,5,17
2020-04-09,1046,03018042,CECIMA,PAVIA,1,1,2
2020-04-09,1047,03016251,SOLZA,BERGAMO,8,6,14
2020-04-09,1048,03013044,CARATE URIO,COMO,3,0,3
2020-04-09,1049,03108040,SEVESO,MONZA E DELLA BRIANZA,42,13,55
2020-04-09,1454,03020055,SAN BENEDETTO PO,MANTOVA,41,3,44
2020-04-09,1456,03012121,SOLBIATE ARNO,VARESE,3,0,3
2020-04-09,1457,03020011,CASALOLDO,MANTOVA,20,5,25
2020-04-09,1458,03018013,BELGIOIOSO,PAVIA,43,10,53
2020-04-09,1459,03013251,COLVERDE,COMO,10,0,10
2020-04-09,1460,03015103,GAGGIANO,MILANO,14,3,17
2020-04-09,1461,03013098,FAGGETO LARIO,COMO,3,0,3
2020-04-09,1462,03018093,MIRADOLO TERME,PAVIA,13,7,20
2020-04-09,1463,03013005,ALBIOLO,COMO,1,0,1
2020-04-09,1464,03015213,SOLARO,MILANO,39,5,44
2020-04-09,1465,03097019,CASTELLO DI BRIANZA,LECCO,6,0,6
2020-04-09,1466,03017183,TAVERNOLE SUL MELLA,BRESCIA,5,0,5
2020-04-09,1467,03017106,MARONE,BRESCIA,11,4,15
2020-04-09,1468,03017107,MAZZANO,BRESCIA,46,7,53
2020-04-09,1469,03018136,SAN GIORGIO DI LOMELLINA,PAVIA,3,0,3
2020-04-09,1474,03013212,SENNA COMASCO,COMO,5,1,6
2020-04-09,1475,03020015,CASTEL GOFFREDO,MANTOVA,92,18,110
2020-04-09,1476,03017088,LENO,BRESCIA,105,21,126
2020-04-09,1138,03017086,ISORELLA,BRESCIA,23,10,33
2020-04-09,1139,03013034,BULGAROGRASSO,COMO,6,1,7
2020-04-09,1140,03098012,CASELLE LURANI,LODI,21,4,25
2020-04-09,1141,03015251,VERMEZZO CON ZELO,MILANO,13,2,15
2020-04-09,1142,03098053,SENNA LODIGIANA,LODI,9,3,12
2020-04-09,1143,03013136,LURAGO D`ERBA,COMO,14,3,17
2020-04-09,1144,03013090,DONGO,COMO,22,1,23
2020-04-09,1145,03018038,CASTELLETTO DI BRANDUZZO,PAVIA,3,2,5
2020-04-09,1146,03017129,PADENGHE SUL GARDA,BRESCIA,55,5,60
2020-04-09,1147,03012097,MARCHIROLO,VARESE,3,0,3
2020-04-09,1148,03014049,PIATEDA,SONDRIO,6,1,7
2020-04-09,1149,03097030,DERVIO,LECCO,10,1,11
2020-04-09,1150,03018162,TRAVACO` SICCOMARIO,PAVIA,14,0,14
2020-04-09,1152,03020048,REDONDESCO,MANTOVA,6,3,9
2020-04-09,1153,03098011,CASELLE LANDI,LODI,18,5,23
2020-04-09,1296,03016022,BEDULITA,BERGAMO,1,1,2
2020-04-09,1297,03020047,QUISTELLO,MANTOVA,10,1,11
2020-04-09,1298,03015027,BOLLATE,MILANO,115,19,134
2020-04-09,1299,03018133,SAN CIPRIANO PO,PAVIA,2,0,2
2020-04-09,1043,03012098,MARNATE,VARESE,10,1,11
2020-04-09,1044,03018185,ZECCONE,PAVIA,6,1,7
2020-04-09,1050,03012114,PORTO VALTRAVAGLIA,VARESE,3,0,3
2020-04-09,1051,03020054,SABBIONETA,MANTOVA,13,3,16
2020-04-09,1052,03017184,TEMU`,BRESCIA,5,1,6
2020-04-09,1470,03019011,CAMPAGNOLA CREMASCA,CREMONA,4,0,4
2020-04-09,1471,03017186,TORBOLE CASAGLIA,BRESCIA,35,15,50
2020-04-09,1154,03015209,SESTO SAN GIOVANNI,MILANO,242,47,289
2020-04-09,1155,03017089,LIMONE SUL GARDA,BRESCIA,1,0,1
2020-04-09,1157,03098046,SALERANO SUL LAMBRO,LODI,16,0,16
2020-04-09,1158,03019098,SORESINA,CREMONA,113,27,140
2020-04-09,1159,03012134,VEDANO OLONA,VARESE,6,0,6
2020-04-09,1160,03016145,OLMO AL BREMBO,BERGAMO,4,4,8
2020-04-09,1161,03020003,BAGNOLO SAN VITO,MANTOVA,17,4,21
2020-04-09,1162,03016134,MEZZOLDO,BERGAMO,1,0,1
2020-04-09,1163,03108053,CORNATE D`ADDA,MONZA E DELLA BRIANZA,28,14,42
2020-04-09,1164,03018151,SOMMO,PAVIA,2,0,2
2020-04-09,1165,03017095,LOZIO,BRESCIA,3,0,3
2020-04-09,1166,03017041,CASTELCOVATI,BRESCIA,34,9,43
2020-04-09,1167,03013199,RONAGO,COMO,3,0,3
2020-04-09,1168,03014051,POGGIRIDENTI,SONDRIO,3,2,5
2020-04-09,1169,03018083,LOMELLO,PAVIA,7,3,10
2020-04-09,1301,03015177,POZZO D`ADDA,MILANO,32,3,35
2020-04-09,1302,03017126,ORZIVECCHI,BRESCIA,16,7,23
2020-04-09,1303,03015202,SAN ZENONE AL LAMBRO,MILANO,26,3,29
2020-04-09,1305,03013118,INVERIGO,COMO,30,8,38
2020-04-09,1306,03097057,OGGIONO,LECCO,36,6,42
2020-04-09,1053,03013216,SORICO,COMO,6,1,7
2020-04-09,1054,03017003,AGNOSINE,BRESCIA,13,7,20
2020-04-09,1055,03012120,SESTO CALENDE,VARESE,9,0,9
2020-04-09,1056,03098035,MALEO,LODI,37,15,52
2020-04-09,1057,03014030,FUSINE,SONDRIO,2,0,2
2020-04-09,1058,03016141,MORNICO AL SERIO,BERGAMO,16,5,21
2020-04-09,1059,03017200,VILLACHIARA,BRESCIA,13,5,18
2020-04-09,1472,03017091,LOGRATO,BRESCIA,23,14,37
2020-04-09,1473,03017150,PONTOGLIO,BRESCIA,53,17,70
2020-04-09,1477,03018011,BASTIDA PANCARANA,PAVIA,8,1,9
2020-04-09,1478,03017012,BARGHE,BRESCIA,5,0,5
2020-04-09,1481,03017058,COLLIO,BRESCIA,5,0,5
2020-04-09,1483,03014026,DELEBIO,SONDRIO,10,2,12
2020-04-09,1487,03108054,LENTATE SUL SEVESO,MONZA E DELLA BRIANZA,29,3,32
2020-04-09,1488,03018031,CASANOVA LONATI,PAVIA,1,0,1
2020-04-09,1170,03097086,VERCURAGO,LECCO,17,6,23
2020-04-09,1171,03018106,OTTOBIANO,PAVIA,8,3,11
2020-04-09,1172,03020033,MARMIROLO,MANTOVA,15,2,17
2020-04-09,1173,03016187,ROVETTA,BERGAMO,40,17,57
2020-04-09,1174,03098050,SANT`ANGELO LODIGIANO,LODI,65,19,84
2020-04-09,1175,03019017,CASALE CREMASCO - VIDOLASCO,CREMONA,10,3,13
2020-04-09,1177,03097056,NIBIONNO,LECCO,8,4,12
2020-04-09,1178,03012119,SARONNO,VARESE,80,15,95
2020-04-09,1179,03013028,BREGNANO,COMO,12,3,15
2020-04-09,1307,03016133,MARTINENGO,BERGAMO,63,34,97
2020-04-09,1308,03020057,SAN GIORGIO BIGARELLO,MANTOVA,23,1,24
2020-04-09,1309,03020038,OSTIGLIA,MANTOVA,19,2,21
2020-04-09,1310,03015230,VAPRIO D`ADDA,MILANO,40,7,47
2020-04-09,1060,03015024,BINASCO,MILANO,18,7,25
2020-04-09,1061,03012014,BIANDRONNO,VARESE,2,0,2
2020-04-09,1063,03016024,BERGAMO,BERGAMO,"1,011",267,"1,278"
2020-04-09,1064,03020008,CANNETO SULL`OGLIO,MANTOVA,55,15,70
2020-04-09,1065,03012142,MACCAGNO CON PINO E VEDDASCA,VARESE,3,0,3
2020-04-09,1066,03012006,AZZATE,VARESE,7,0,7
2020-04-09,1067,03016009,AMBIVERE,BERGAMO,16,3,19
2020-04-09,1068,03012139,VIGGIU`,VARESE,5,2,7
2020-04-09,1069,03014045,MORBEGNO,SONDRIO,29,4,33
2020-04-09,1071,03019092,SCANDOLARA RAVARA,CREMONA,22,1,23
2020-04-09,1072,03016160,PEDRENGO,BERGAMO,32,23,55
2020-04-09,1073,03017069,ERBUSCO,BRESCIA,51,17,68
2020-04-09,1074,03016111,GAZZANIGA,BERGAMO,65,15,80
2020-04-09,1075,03014052,PONTE IN VALTELLINA,SONDRIO,9,0,9
2020-04-09,1076,03012050,CISLAGO,VARESE,16,3,19
2020-04-09,1077,03020030,MANTOVA,MANTOVA,173,33,206
2020-04-09,1484,03017164,ROE` VOLCIANO,BRESCIA,21,4,25
2020-04-09,1485,03015176,POGLIANO MILANESE,MILANO,34,10,44
2020-04-09,1180,03108048,VERANO BRIANZA,MONZA E DELLA BRIANZA,24,2,26
2020-04-09,1181,03016046,CALUSCO D`ADDA,BERGAMO,65,19,84
2020-04-09,1182,03018140,SANTA GIULETTA,PAVIA,11,5,16
2020-04-09,1183,03015139,MEDIGLIA,MILANO,89,27,116
2020-04-09,1184,03015164,OSSONA,MILANO,22,0,22
2020-04-09,1185,03017019,BIONE,BRESCIA,10,3,13
2020-04-09,1186,03097013,CALOLZIOCORTE,LECCO,100,22,122
2020-04-09,1187,03018047,CERVESINA,PAVIA,9,4,13
2020-04-09,1188,03108051,BUSNAGO,MONZA E DELLA BRIANZA,21,8,29
2020-04-09,1189,03016170,PONTE SAN PIETRO,BERGAMO,79,31,110
2020-04-09,1190,03018100,MONTU` BECCARIA,PAVIA,8,4,12
2020-04-09,1191,03015011,ASSAGO,MILANO,16,4,20
2020-04-09,1192,03098009,CASALMAIOCCO,LODI,19,5,24
2020-04-09,1193,03013119,LAGLIO,COMO,2,0,2
2020-04-09,1194,03098057,TERRANOVA DEI PASSERINI,LODI,9,0,9
2020-04-09,1195,03014050,PIURO,SONDRIO,1,4,5
2020-04-09,1196,03020062,SERRAVALLE A PO,MANTOVA,40,1,41
2020-04-09,1197,03019050,GRONTARDO,CREMONA,14,1,15
2020-04-09,1198,03018029,CANNETO PAVESE,PAVIA,2,1,3
2020-04-09,1311,03013009,ANZANO DEL PARCO,COMO,2,0,2
2020-04-09,1312,03108013,BURAGO DI MOLGORA,MONZA E DELLA BRIANZA,8,1,9
2020-04-09,1313,03016105,FORNOVO SAN GIOVANNI,BERGAMO,18,9,27
2020-04-09,1315,03016097,FARA OLIVANA CON SOLA,BERGAMO,4,3,7
2020-04-09,1316,03013077,CORRIDO,COMO,4,0,4
2020-04-09,1070,03108035,NOVA MILANESE,MONZA E DELLA BRIANZA,95,17,112
2020-04-09,1078,03016199,SERINA,BERGAMO,13,9,22
2020-04-09,1079,03097091,VERDERIO,LECCO,39,7,46
2020-04-09,1080,03015087,CORNAREDO,MILANO,52,9,61
2020-04-09,1081,03018080,LARDIRAGO,PAVIA,3,0,3
2020-04-09,1486,03019105,TORLINO VIMERCATI,CREMONA,0,1,1
2020-04-09,1489,03013139,MAGREGLIO,COMO,1,0,1
2020-04-09,1490,03019090,SAN GIOVANNI IN CROCE,CREMONA,9,0,9
2020-04-09,1491,03019085,ROBECCO D`OGLIO,CREMONA,19,3,22
2020-04-09,1493,03018051,CODEVILLA,PAVIA,0,1,1
2020-04-09,1494,03020043,POMPONESCO,MANTOVA,4,3,7
2020-04-09,1495,03016241,VILLA D`OGNA,BERGAMO,24,4,28
2020-04-09,1496,03017153,PRESEGLIE,BRESCIA,9,2,11
2020-04-09,1497,03097014,CARENNO,LECCO,7,2,9
2020-04-09,1498,03015154,NERVIANO,MILANO,41,4,45
2020-04-09,1499,03017195,VEROLANUOVA,BRESCIA,91,28,119
2020-04-09,1500,03012064,DAVERIO,VARESE,2,0,2
2020-04-09,1501,03098019,CODOGNO,LODI,215,80,295
2020-04-09,1502,03013185,PLESIO,COMO,2,0,2
2020-04-09,1503,03017083,INCUDINE,BRESCIA,1,0,1
2020-04-09,1505,03017075,GARDONE VAL TROMPIA,BRESCIA,60,14,74
2020-04-09,1506,03097029,CREMENO,LECCO,7,3,10
2020-04-09,1199,03012003,ANGERA,VARESE,2,1,3
2020-04-09,1201,03019033,CORTE DE` FRATI,CREMONA,25,8,33
2020-04-09,1202,03017171,SAN FELICE DEL BENACO,BRESCIA,15,4,19
2020-04-09,1203,03016031,BONATE SOTTO,BERGAMO,30,8,38
2020-04-09,1204,03017119,NUVOLENTO,BRESCIA,10,2,12
2020-04-09,1318,03019025,CASTELLEONE,CREMONA,170,35,205
2020-04-09,1319,03097028,CREMELLA,LECCO,7,1,8
2020-04-09,1320,03018143,SANTA MARIA DELLA VERSA,PAVIA,4,0,4
2020-04-09,1321,03018190,ZINASCO,PAVIA,10,2,12
2020-04-09,1322,03018108,PANCARANA,PAVIA,0,2,2
2020-04-09,1323,03108041,SOVICO,MONZA E DELLA BRIANZA,16,3,19
2020-04-09,1324,03017104,MARCHENO,BRESCIA,24,6,30
2020-04-09,1082,03012132,VARANO BORGHI,VARESE,3,0,3
2020-04-09,1083,03014008,BIANZONE,SONDRIO,11,3,14
2020-04-09,1084,03015237,VIGNATE,MILANO,40,5,45
2020-04-09,1085,03013058,CASTELMARTE,COMO,3,1,4
2020-04-09,1086,03016086,COSTA VOLPINO,BERGAMO,56,13,69
2020-04-09,1087,03017203,VISANO,BRESCIA,12,2,14
2020-04-09,1088,03016065,CASTRO,BERGAMO,8,4,12
2020-04-09,1089,03013023,BINAGO,COMO,5,1,6
2020-04-09,1090,03016130,LUZZANA,BERGAMO,7,0,7
2020-04-09,1091,03019086,ROMANENGO,CREMONA,38,9,47
2020-04-09,1206,03016044,CALCIO,BERGAMO,24,14,38
2020-04-09,1207,03015046,CANEGRATE,MILANO,25,3,28
2020-04-09,1208,03013160,MUSSO,COMO,5,0,5
2020-04-09,1210,03012034,CARONNO PERTUSELLA,VARESE,50,10,60
2020-04-09,1211,03015081,COLOGNO MONZESE,MILANO,267,60,327
2020-04-09,1326,03015035,BUBBIANO,MILANO,5,0,5
2020-04-09,1327,03098020,COMAZZO,LODI,5,3,8
2020-04-09,1328,03016087,COVO,BERGAMO,26,11,37
2020-04-09,1093,03020021,CURTATONE,MANTOVA,50,4,54
2020-04-09,1094,03020019,CERESARA,MANTOVA,6,5,11
2020-04-09,1095,03015118,LEGNANO,MILANO,171,29,200
2020-04-09,1096,03097031,DOLZAGO,LECCO,3,4,7
2020-04-09,1097,03013007,ALZATE BRIANZA,COMO,14,0,14
2020-04-09,1098,03014068,TOVO DI SANT`AGATA,SONDRIO,1,0,1
2020-04-09,1099,03016131,MADONE,BERGAMO,22,9,31
2020-04-09,1100,03016208,STROZZA,BERGAMO,8,2,10
2020-04-09,1101,03016036,BRANZI,BERGAMO,1,2,3
2020-04-09,1105,03012055,COMERIO,VARESE,4,1,5
2020-04-09,1106,03014019,CHIESA IN VALMALENCO,SONDRIO,6,1,7
2020-04-09,1212,03020020,COMMESSAGGIO,MANTOVA,2,0,2
2020-04-09,1213,03012007,AZZIO,VARESE,2,0,2
2020-04-09,1214,03017136,PASSIRANO,BRESCIA,51,10,61
2020-04-09,1215,03018084,LUNGAVILLA,PAVIA,8,2,10
2020-04-09,1216,03019036,CREMONA,CREMONA,"1,005",149,"1,154"
2020-04-09,1217,03014039,MANTELLO,SONDRIO,1,0,1
2020-04-09,1218,03015010,ARLUNO,MILANO,38,3,41
2020-04-09,1329,03019101,SPINEDA,CREMONA,7,2,9
2020-04-09,1330,03016110,GAVERINA TERME,BERGAMO,7,2,9
2020-04-09,1331,03018005,ARENA PO,PAVIA,7,4,11
2020-04-09,1332,03018102,MORTARA,PAVIA,65,24,89
2020-04-09,1333,03012053,COCQUIO - TREVISAGO,VARESE,71,0,71
2020-04-09,1334,03017052,CHIARI,BRESCIA,146,43,189
2020-04-09,1335,03097006,BARZANO`,LECCO,14,0,14
2020-04-09,1336,03015211,SETTIMO MILANESE,MILANO,77,16,93
2020-04-09,1337,03018053,COPIANO,PAVIA,3,0,3
2020-04-09,1338,03108017,CAVENAGO DI BRIANZA,MONZA E DELLA BRIANZA,33,9,42
2020-04-09,1339,03018030,CARBONARA AL TICINO,PAVIA,8,1,9
2020-04-09,1340,03012123,SOMMA LOMBARDO,VARESE,21,1,22
2020-04-09,1341,03018074,GOLFERENZO,PAVIA,2,0,2
2020-04-09,1342,03018116,PIZZALE,PAVIA,4,1,5
2020-04-09,1343,03014041,MELLO,SONDRIO,1,0,1
2020-04-09,1344,03017006,ANGOLO TERME,BRESCIA,18,4,22
2020-04-09,1350,03018149,SILVANO PIETRA,PAVIA,1,0,1
2020-04-09,1102,03015248,VILLA CORTESE,MILANO,20,3,23
2020-04-09,1103,03015159,OPERA,MILANO,21,6,27
2020-04-09,1219,03016038,BREMBATE DI SOPRA,BERGAMO,65,12,77
2020-04-09,1220,03097024,COLLE BRIANZA,LECCO,5,1,6
2020-04-09,1221,03018032,CASATISMA,PAVIA,4,3,7
2020-04-09,1222,03017051,CEVO,BRESCIA,13,2,15
2020-04-09,1223,03013029,BRENNA,COMO,9,1,10
2020-04-09,1226,03017085,ISEO,BRESCIA,79,12,91
2020-04-09,1345,03016250,MEDOLAGO,BERGAMO,13,1,14
2020-04-09,1346,03019019,CASALETTO DI SOPRA,CREMONA,3,3,6
2020-04-09,1104,03019024,CASTEL GABBIANO,CREMONA,0,3,3
2020-04-09,1107,03012080,GORNATE OLONA,VARESE,4,1,5
2020-04-09,1108,03015099,DAIRAGO,MILANO,7,1,8
2020-04-09,1109,03019045,GABBIONETA BINANUOVA,CREMONA,18,0,18
2020-04-09,1110,03014048,PIANTEDO,SONDRIO,5,0,5
2020-04-09,1111,03016135,MISANO DI GERA D`ADDA,BERGAMO,17,7,24
2020-04-09,1112,03012029,CAIRATE,VARESE,5,1,6
2020-04-09,1113,03108055,RONCELLO,MONZA E DELLA BRIANZA,21,2,23
2020-04-09,1114,03018019,BORNASCO,PAVIA,3,2,5
2020-04-09,1227,03018063,FILIGHERA,PAVIA,3,2,5
2020-04-09,1228,03014046,NOVATE MEZZOLA,SONDRIO,3,2,5
2020-04-09,1229,03013041,CANTU`,COMO,71,13,84
2020-04-09,1230,03017117,NAVE,BRESCIA,74,16,90
2020-04-09,1231,03016207,STEZZANO,BERGAMO,92,30,122
2020-04-09,1232,03016173,PRADALUNGA,BERGAMO,30,27,57
2020-04-09,1234,03016106,FUIPIANO VALLE IMAGNA,BERGAMO,0,2,2
2020-04-09,1235,03017115,MURA,BRESCIA,5,2,7
2020-04-09,1236,03017033,CALVAGESE DELLA RIVIERA,BRESCIA,7,1,8
2020-04-09,1237,03013011,ARGEGNO,COMO,2,0,2
2020-04-09,1238,03016088,CREDARO,BERGAMO,10,8,18
2020-04-09,1239,03016052,CAPRINO BERGAMASCO,BERGAMO,24,8,32
2020-04-09,1240,03020026,GOITO,MANTOVA,44,16,60
2020-04-09,1241,03013193,PUSIANO,COMO,3,0,3
2020-04-09,1242,03013064,CERMENATE,COMO,15,3,18
2020-04-09,1243,03108003,ALBIATE,MONZA E DELLA BRIANZA,14,2,16
2020-04-09,1347,03016089,CURNO,BERGAMO,50,15,65
2020-04-09,1348,03015042,CALVIGNASCO,MILANO,0,2,2
2020-04-09,1115,03017048,CELLATICA,BRESCIA,27,4,31
2020-04-09,1116,03018081,LINAROLO,PAVIA,13,3,16
2020-04-09,1117,03013013,ASSO,COMO,18,2,20
2020-04-09,1118,03017158,PUEGNAGO SUL GARDA,BRESCIA,12,2,14
2020-04-09,1119,03015182,RHO,MILANO,166,22,188
2020-04-09,1121,03018092,MEZZANINO,PAVIA,7,0,7
